"filename", "language", "Vue", "TypeScript", "JSON", "SCSS", "XML", "comment", "blank", "total"
"f:\研奇\dashboard-view\src\App.vue", "Vue", 46, 0, 0, 0, 0, 2, 8, 56
"f:\研奇\dashboard-view\src\api\axios.ts", "TypeScript", 0, 29, 0, 0, 0, 2, 6, 37
"f:\研奇\dashboard-view\src\api\http.ts", "TypeScript", 0, 343, 0, 0, 0, 32, 67, 442
"f:\研奇\dashboard-view\src\api\mock\graph.json", "JSON", 0, 0, 100, 0, 0, 0, 0, 100
"f:\研奇\dashboard-view\src\api\mock\heatMapData.json", "JSON", 0, 0, 199, 0, 0, 0, 1, 200
"f:\研奇\dashboard-view\src\api\mock\index.ts", "TypeScript", 0, 114, 0, 0, 0, 3, 4, 121
"f:\研奇\dashboard-view\src\api\mock\map.json", "JSON", 0, 0, 9, 0, 0, 0, 1, 10
"f:\研奇\dashboard-view\src\api\mock\sankey.json", "JSON", 0, 0, 86, 0, 0, 0, 1, 87
"f:\研奇\dashboard-view\src\api\mock\scatter.json", "JSON", 0, 0, 56, 0, 0, 0, 1, 57
"f:\研奇\dashboard-view\src\api\mock\test.mock.ts", "TypeScript", 0, 220, 0, 0, 0, 18, 2, 240
"f:\研奇\dashboard-view\src\api\mock\treemap.json", "JSON", 0, 0, 50, 0, 0, 0, 1, 51
"f:\研奇\dashboard-view\src\assets\data\demonstration.json", "JSON", 0, 0, 1848, 0, 0, 0, 0, 1848
"f:\研奇\dashboard-view\src\assets\images\Error.svg", "XML", 0, 0, 0, 0, 253, 1, 2, 256
"f:\研奇\dashboard-view\src\assets\images\exception\403.svg", "XML", 0, 0, 0, 0, 1, 0, 0, 1
"f:\研奇\dashboard-view\src\assets\images\exception\404.svg", "XML", 0, 0, 0, 0, 1, 0, 0, 1
"f:\研奇\dashboard-view\src\assets\images\exception\500.svg", "XML", 0, 0, 0, 0, 1, 0, 0, 1
"f:\研奇\dashboard-view\src\assets\images\exception\developing.svg", "XML", 0, 0, 0, 0, 1, 0, 0, 1
"f:\研奇\dashboard-view\src\assets\images\exception\load-error.svg", "XML", 0, 0, 0, 0, 1, 0, 0, 1
"f:\研奇\dashboard-view\src\assets\images\exception\nodata.svg", "XML", 0, 0, 0, 0, 1, 0, 0, 1
"f:\研奇\dashboard-view\src\assets\images\tips\loadingSvg.svg", "XML", 0, 0, 0, 0, 19, 0, 0, 19
"f:\研奇\dashboard-view\src\components\GoAppProvider\index.ts", "TypeScript", 0, 2, 0, 0, 0, 0, 2, 4
"f:\研奇\dashboard-view\src\components\GoAppProvider\index.vue", "Vue", 25, 0, 0, 0, 0, 0, 4, 29
"f:\研奇\dashboard-view\src\components\GoIconify\index.ts", "TypeScript", 0, 2, 0, 0, 0, 0, 2, 4
"f:\研奇\dashboard-view\src\components\GoIconify\index.vue", "Vue", 33, 0, 0, 0, 0, 0, 2, 35
"f:\研奇\dashboard-view\src\components\GoLangSelect\index.ts", "TypeScript", 0, 2, 0, 0, 0, 0, 2, 4
"f:\研奇\dashboard-view\src\components\GoLangSelect\index.vue", "Vue", 17, 0, 0, 0, 0, 0, 4, 21
"f:\研奇\dashboard-view\src\components\GoLoading\LoadingSkeleton.vue", "Vue", 5, 0, 0, 0, 0, 1, 0, 6
"f:\研奇\dashboard-view\src\components\GoLoading\index.ts", "TypeScript", 0, 12, 0, 0, 0, 2, 4, 18
"f:\研奇\dashboard-view\src\components\GoLoading\index.vue", "Vue", 15, 0, 0, 0, 0, 1, 1, 17
"f:\研奇\dashboard-view\src\components\GoReload\index.ts", "TypeScript", 0, 2, 0, 0, 0, 0, 2, 4
"f:\研奇\dashboard-view\src\components\GoReload\index.vue", "Vue", 18, 0, 0, 0, 0, 0, 3, 21
"f:\研奇\dashboard-view\src\components\GoSkeleton\index.ts", "TypeScript", 0, 2, 0, 0, 0, 0, 2, 4
"f:\研奇\dashboard-view\src\components\GoSkeleton\index.vue", "Vue", 37, 0, 0, 0, 0, 0, 2, 39
"f:\研奇\dashboard-view\src\components\GoSystemInfo\index.ts", "TypeScript", 0, 2, 0, 0, 0, 0, 2, 4
"f:\研奇\dashboard-view\src\components\GoSystemInfo\index.vue", "Vue", 56, 0, 0, 0, 0, 0, 8, 64
"f:\研奇\dashboard-view\src\components\GoSystemSet\index.d.ts", "TypeScript", 0, 12, 0, 0, 0, 0, 1, 13
"f:\研奇\dashboard-view\src\components\GoSystemSet\index.ts", "TypeScript", 0, 2, 0, 0, 0, 0, 2, 4
"f:\研奇\dashboard-view\src\components\GoSystemSet\index.vue", "Vue", 190, 0, 0, 0, 0, 4, 14, 208
"f:\研奇\dashboard-view\src\components\GoThemeSelect\index.ts", "TypeScript", 0, 2, 0, 0, 0, 0, 2, 4
"f:\研奇\dashboard-view\src\components\GoThemeSelect\index.vue", "Vue", 20, 0, 0, 0, 0, 0, 3, 23
"f:\研奇\dashboard-view\src\components\GoUserInfo\index.ts", "TypeScript", 0, 2, 0, 0, 0, 0, 2, 4
"f:\研奇\dashboard-view\src\components\GoUserInfo\index.vue", "Vue", 113, 0, 0, 0, 0, 3, 13, 129
"f:\研奇\dashboard-view\src\components\I18n\index.ts", "TypeScript", 0, 2, 0, 0, 0, 0, 2, 4
"f:\研奇\dashboard-view\src\components\I18n\index.vue", "Vue", 6, 0, 0, 0, 0, 1, 2, 9
"f:\研奇\dashboard-view\src\components\Pages\ChartGlobImage\index.ts", "TypeScript", 0, 2, 0, 0, 0, 0, 2, 4
"f:\研奇\dashboard-view\src\components\Pages\ChartGlobImage\index.vue", "Vue", 26, 0, 0, 0, 0, 0, 6, 32
"f:\研奇\dashboard-view\src\components\Pages\ChartItemSetting\CollapseItem.vue", "Vue", 31, 0, 0, 0, 0, 1, 5, 37
"f:\研奇\dashboard-view\src\components\Pages\ChartItemSetting\EchartsRendererSetting.vue", "Vue", 41, 0, 0, 0, 0, 0, 5, 46
"f:\研奇\dashboard-view\src\components\Pages\ChartItemSetting\GlobalSetting.vue", "Vue", 385, 0, 0, 0, 0, 0, 20, 405
"f:\研奇\dashboard-view\src\components\Pages\ChartItemSetting\GlobalSettingPosition.vue", "Vue", 26, 0, 0, 0, 0, 0, 4, 30
"f:\研奇\dashboard-view\src\components\Pages\ChartItemSetting\NameSetting.vue", "Vue", 38, 0, 0, 0, 0, 0, 5, 43
"f:\研奇\dashboard-view\src\components\Pages\ChartItemSetting\PositionSetting.vue", "Vue", 124, 0, 0, 0, 0, 0, 6, 130
"f:\研奇\dashboard-view\src\components\Pages\ChartItemSetting\SettingItem.vue", "Vue", 30, 0, 0, 0, 0, 0, 3, 33
"f:\研奇\dashboard-view\src\components\Pages\ChartItemSetting\SettingItemBox.vue", "Vue", 57, 0, 0, 0, 0, 0, 3, 60
"f:\研奇\dashboard-view\src\components\Pages\ChartItemSetting\SizeSetting.vue", "Vue", 42, 0, 0, 0, 0, 0, 4, 46
"f:\研奇\dashboard-view\src\components\Pages\ChartItemSetting\StylesSetting.vue", "Vue", 214, 0, 0, 0, 0, 13, 15, 242
"f:\研奇\dashboard-view\src\components\Pages\ChartItemSetting\index.ts", "TypeScript", 0, 10, 0, 0, 0, 7, 4, 21
"f:\研奇\dashboard-view\src\components\Pages\Flipper\index.ts", "TypeScript", 0, 3, 0, 0, 0, 0, 3, 6
"f:\研奇\dashboard-view\src\components\Pages\Flipper\index.vue", "Vue", 233, 0, 0, 0, 0, 0, 13, 246
"f:\研奇\dashboard-view\src\components\Pages\MonacoEditor\EditorWorker.vue", "Vue", 22, 0, 0, 0, 0, 0, 3, 25
"f:\研奇\dashboard-view\src\components\Pages\MonacoEditor\index.hook.ts", "TypeScript", 0, 53, 0, 0, 0, 15, 9, 77
"f:\研奇\dashboard-view\src\components\Pages\MonacoEditor\index.ts", "TypeScript", 0, 3, 0, 0, 0, 0, 2, 5
"f:\研奇\dashboard-view\src\components\Pages\MonacoEditor\index.vue", "Vue", 83, 0, 0, 0, 0, 0, 10, 93
"f:\研奇\dashboard-view\src\components\Pages\ThemeColorSelect\components\ColorList.vue", "Vue", 111, 0, 0, 0, 0, 0, 4, 115
"f:\研奇\dashboard-view\src\components\Pages\ThemeColorSelect\index.ts", "TypeScript", 0, 2, 0, 0, 0, 0, 2, 4
"f:\研奇\dashboard-view\src\components\Pages\ThemeColorSelect\index.vue", "Vue", 157, 0, 0, 0, 0, 0, 11, 168
"f:\研奇\dashboard-view\src\components\Plugins\DialogContent\index.ts", "TypeScript", 0, 2, 0, 0, 0, 0, 2, 4
"f:\研奇\dashboard-view\src\components\Plugins\DialogContent\index.vue", "Vue", 6, 0, 0, 0, 0, 1, 1, 8
"f:\研奇\dashboard-view\src\components\Plugins\LoadingContent\index.ts", "TypeScript", 0, 2, 0, 0, 0, 0, 2, 4
"f:\研奇\dashboard-view\src\components\Plugins\LoadingContent\index.vue", "Vue", 7, 0, 0, 0, 0, 1, 2, 10
"f:\研奇\dashboard-view\src\components\Plugins\MessageContent\index.ts", "TypeScript", 0, 2, 0, 0, 0, 0, 2, 4
"f:\研奇\dashboard-view\src\components\Plugins\MessageContent\index.vue", "Vue", 6, 0, 0, 0, 0, 1, 2, 9
"f:\研奇\dashboard-view\src\components\Tips\MacOsControlBtn\index.ts", "TypeScript", 0, 2, 0, 0, 0, 0, 2, 4
"f:\研奇\dashboard-view\src\components\Tips\MacOsControlBtn\index.vue", "Vue", 134, 0, 0, 0, 0, 0, 9, 143
"f:\研奇\dashboard-view\src\directives\index.ts", "TypeScript", 0, 1, 0, 0, 0, 0, 0, 1
"f:\研奇\dashboard-view\src\enums\editPageEnum.ts", "TypeScript", 0, 55, 0, 0, 0, 26, 6, 87
"f:\研奇\dashboard-view\src\enums\eventEnum.ts", "TypeScript", 0, 37, 0, 0, 0, 16, 7, 60
"f:\研奇\dashboard-view\src\enums\fileTypeEnum.ts", "TypeScript", 0, 7, 0, 0, 0, 3, 1, 11
"f:\研奇\dashboard-view\src\enums\httpEnum.ts", "TypeScript", 0, 75, 0, 0, 0, 43, 11, 129
"f:\研奇\dashboard-view\src\enums\pageEnum.ts", "TypeScript", 0, 46, 0, 0, 0, 11, 17, 74
"f:\研奇\dashboard-view\src\enums\pluginEnum.ts", "TypeScript", 0, 6, 0, 0, 0, 0, 1, 7
"f:\研奇\dashboard-view\src\enums\storageEnum.ts", "TypeScript", 0, 10, 0, 0, 0, 8, 1, 19
"f:\研奇\dashboard-view\src\enums\styleEnum.ts", "TypeScript", 0, 14, 0, 0, 0, 3, 2, 19
"f:\研奇\dashboard-view\src\hooks\index.ts", "TypeScript", 0, 8, 0, 0, 0, 0, 0, 8
"f:\研奇\dashboard-view\src\hooks\useCanvasInitOptions.hook.ts", "TypeScript", 0, 21, 0, 0, 0, 1, 5, 27
"f:\研奇\dashboard-view\src\hooks\useChartDataFetch.hook.ts", "TypeScript", 0, 93, 0, 0, 0, 22, 16, 131
"f:\研奇\dashboard-view\src\hooks\useChartDataPondFetch.hook.ts", "TypeScript", 0, 94, 0, 0, 0, 19, 19, 132
"f:\研奇\dashboard-view\src\hooks\useChartInteract.hook.ts", "TypeScript", 0, 49, 0, 0, 0, 3, 8, 60
"f:\研奇\dashboard-view\src\hooks\useCode.hook.ts", "TypeScript", 0, 8, 0, 0, 0, 1, 2, 11
"f:\研奇\dashboard-view\src\hooks\useLang.hook.ts", "TypeScript", 0, 18, 0, 0, 0, 1, 6, 25
"f:\研奇\dashboard-view\src\hooks\useLifeHandler.hook.ts", "TypeScript", 0, 54, 0, 0, 0, 18, 8, 80
"f:\研奇\dashboard-view\src\hooks\usePreviewScale.hook.ts", "TypeScript", 0, 163, 0, 0, 0, 26, 29, 218
"f:\研奇\dashboard-view\src\hooks\useTheme.hook.ts", "TypeScript", 0, 89, 0, 0, 0, 7, 4, 100
"f:\研奇\dashboard-view\src\i18n\en\dashboard.ts", "TypeScript", 0, 93, 0, 0, 0, 7, 13, 113
"f:\研奇\dashboard-view\src\i18n\en\device.ts", "TypeScript", 0, 46, 0, 0, 0, 3, 7, 56
"f:\研奇\dashboard-view\src\i18n\en\index.ts", "TypeScript", 0, 44, 0, 0, 0, 3, 3, 50
"f:\研奇\dashboard-view\src\i18n\en\login.ts", "TypeScript", 0, 10, 0, 0, 0, 0, 0, 10
"f:\研奇\dashboard-view\src\i18n\en\menu.ts", "TypeScript", 0, 9, 0, 0, 0, 0, 1, 10
"f:\研奇\dashboard-view\src\i18n\en\message.ts", "TypeScript", 0, 5, 0, 0, 0, 1, 1, 7
"f:\研奇\dashboard-view\src\i18n\en\msg.ts", "TypeScript", 0, 13, 0, 0, 0, 3, 2, 18
"f:\研奇\dashboard-view\src\i18n\en\project.ts", "TypeScript", 0, 13, 0, 0, 0, 1, 2, 16
"f:\研奇\dashboard-view\src\i18n\index.ts", "TypeScript", 0, 30, 0, 0, 0, 2, 5, 37
"f:\研奇\dashboard-view\src\i18n\zh\dashboard.ts", "TypeScript", 0, 93, 0, 0, 0, 7, 12, 112
"f:\研奇\dashboard-view\src\i18n\zh\device.ts", "TypeScript", 0, 46, 0, 0, 0, 3, 8, 57
"f:\研奇\dashboard-view\src\i18n\zh\index.ts", "TypeScript", 0, 44, 0, 0, 0, 3, 3, 50
"f:\研奇\dashboard-view\src\i18n\zh\login.ts", "TypeScript", 0, 10, 0, 0, 0, 0, 0, 10
"f:\研奇\dashboard-view\src\i18n\zh\menu.ts", "TypeScript", 0, 9, 0, 0, 0, 0, 1, 10
"f:\研奇\dashboard-view\src\i18n\zh\message.ts", "TypeScript", 0, 5, 0, 0, 0, 1, 1, 7
"f:\研奇\dashboard-view\src\i18n\zh\msg.ts", "TypeScript", 0, 13, 0, 0, 0, 3, 2, 18
"f:\研奇\dashboard-view\src\i18n\zh\project.ts", "TypeScript", 0, 13, 0, 0, 0, 2, 2, 17
"f:\研奇\dashboard-view\src\layout\components\LayoutFooter\index.ts", "TypeScript", 0, 2, 0, 0, 0, 0, 1, 3
"f:\研奇\dashboard-view\src\layout\components\LayoutFooter\index.vue", "Vue", 32, 0, 0, 0, 0, 0, 3, 35
"f:\研奇\dashboard-view\src\layout\components\LayoutHeaderPro\index.ts", "TypeScript", 0, 2, 0, 0, 0, 0, 1, 3
"f:\研奇\dashboard-view\src\layout\components\LayoutHeaderPro\index.vue", "Vue", 35, 0, 0, 0, 0, 0, 4, 39
"f:\研奇\dashboard-view\src\layout\components\LayoutHeader\index.ts", "TypeScript", 0, 2, 0, 0, 0, 0, 1, 3
"f:\研奇\dashboard-view\src\layout\components\LayoutHeader\index.vue", "Vue", 71, 0, 0, 0, 0, 3, 6, 80
"f:\研奇\dashboard-view\src\layout\components\LayoutMain\index.ts", "TypeScript", 0, 2, 0, 0, 0, 0, 2, 4
"f:\研奇\dashboard-view\src\layout\components\LayoutMain\index.vue", "Vue", 10, 0, 0, 0, 0, 0, 1, 11
"f:\研奇\dashboard-view\src\layout\components\LayoutTransitionMain\index.ts", "TypeScript", 0, 2, 0, 0, 0, 0, 2, 4
"f:\研奇\dashboard-view\src\layout\components\LayoutTransitionMain\index.vue", "Vue", 14, 0, 0, 0, 0, 0, 1, 15
"f:\研奇\dashboard-view\src\layout\index.vue", "Vue", 6, 0, 0, 0, 0, 0, 1, 7
"f:\研奇\dashboard-view\src\layout\parentLayout.vue", "Vue", 3, 0, 0, 0, 0, 0, 1, 4
"f:\研奇\dashboard-view\src\main.ts", "TypeScript", 0, 44, 0, 0, 0, 17, 23, 84
"f:\研奇\dashboard-view\src\packages\chartConfiguration\echarts\axis.ts", "TypeScript", 0, 52, 0, 0, 0, 4, 1, 57
"f:\研奇\dashboard-view\src\packages\chartConfiguration\echarts\index.ts", "TypeScript", 0, 4, 0, 0, 0, 0, 0, 4
"f:\研奇\dashboard-view\src\packages\chartConfiguration\echarts\label.ts", "TypeScript", 0, 7, 0, 0, 0, 0, 1, 8
"f:\研奇\dashboard-view\src\packages\chartConfiguration\echarts\legend.ts", "TypeScript", 0, 66, 0, 0, 0, 4, 1, 71
"f:\研奇\dashboard-view\src\packages\chartConfiguration\echarts\line.ts", "TypeScript", 0, 18, 0, 0, 0, 0, 1, 19
"f:\研奇\dashboard-view\src\packages\components\Charts\AirConditioner\Dry\config.ts", "TypeScript", 0, 17, 0, 0, 0, 0, 3, 20
"f:\研奇\dashboard-view\src\packages\components\Charts\AirConditioner\Dry\config.vue", "Vue", 25, 0, 0, 0, 0, 0, 5, 30
"f:\研奇\dashboard-view\src\packages\components\Charts\AirConditioner\Dry\index.ts", "TypeScript", 0, 14, 0, 0, 0, 0, 2, 16
"f:\研奇\dashboard-view\src\packages\components\Charts\AirConditioner\Dry\index.vue", "Vue", 37, 0, 0, 0, 0, 0, 7, 44
"f:\研奇\dashboard-view\src\packages\components\Charts\AirConditioner\Fan2\config.ts", "TypeScript", 0, 17, 0, 0, 0, 0, 3, 20
"f:\研奇\dashboard-view\src\packages\components\Charts\AirConditioner\Fan2\config.vue", "Vue", 25, 0, 0, 0, 0, 0, 5, 30
"f:\研奇\dashboard-view\src\packages\components\Charts\AirConditioner\Fan2\index.ts", "TypeScript", 0, 14, 0, 0, 0, 0, 1, 15
"f:\研奇\dashboard-view\src\packages\components\Charts\AirConditioner\Fan2\index.vue", "Vue", 37, 0, 0, 0, 0, 0, 7, 44
"f:\研奇\dashboard-view\src\packages\components\Charts\AirConditioner\Humidify\config.ts", "TypeScript", 0, 17, 0, 0, 0, 0, 3, 20
"f:\研奇\dashboard-view\src\packages\components\Charts\AirConditioner\Humidify\config.vue", "Vue", 25, 0, 0, 0, 0, 0, 5, 30
"f:\研奇\dashboard-view\src\packages\components\Charts\AirConditioner\Humidify\index.ts", "TypeScript", 0, 14, 0, 0, 0, 0, 1, 15
"f:\研奇\dashboard-view\src\packages\components\Charts\AirConditioner\Humidify\index.vue", "Vue", 37, 0, 0, 0, 0, 0, 7, 44
"f:\研奇\dashboard-view\src\packages\components\Charts\AirConditioner\Snow\config.ts", "TypeScript", 0, 17, 0, 0, 0, 0, 3, 20
"f:\研奇\dashboard-view\src\packages\components\Charts\AirConditioner\Snow\config.vue", "Vue", 25, 0, 0, 0, 0, 0, 5, 30
"f:\研奇\dashboard-view\src\packages\components\Charts\AirConditioner\Snow\index.ts", "TypeScript", 0, 14, 0, 0, 0, 0, 1, 15
"f:\研奇\dashboard-view\src\packages\components\Charts\AirConditioner\Snow\index.vue", "Vue", 37, 0, 0, 0, 0, 0, 7, 44
"f:\研奇\dashboard-view\src\packages\components\Charts\AirConditioner\Sun\config.ts", "TypeScript", 0, 17, 0, 0, 0, 0, 3, 20
"f:\研奇\dashboard-view\src\packages\components\Charts\AirConditioner\Sun\config.vue", "Vue", 25, 0, 0, 0, 0, 0, 5, 30
"f:\研奇\dashboard-view\src\packages\components\Charts\AirConditioner\Sun\index.ts", "TypeScript", 0, 14, 0, 0, 0, 0, 1, 15
"f:\研奇\dashboard-view\src\packages\components\Charts\AirConditioner\Sun\index.vue", "Vue", 37, 0, 0, 0, 0, 0, 8, 45
"f:\研奇\dashboard-view\src\packages\components\Charts\AirConditioner\Switch\config.ts", "TypeScript", 0, 16, 0, 0, 0, 0, 3, 19
"f:\研奇\dashboard-view\src\packages\components\Charts\AirConditioner\Switch\config.vue", "Vue", 25, 0, 0, 0, 0, 0, 2, 27
"f:\研奇\dashboard-view\src\packages\components\Charts\AirConditioner\Switch\index.ts", "TypeScript", 0, 14, 0, 0, 0, 0, 1, 15
"f:\研奇\dashboard-view\src\packages\components\Charts\AirConditioner\Switch\index.vue", "Vue", 92, 0, 0, 0, 0, 0, 12, 104
"f:\研奇\dashboard-view\src\packages\components\Charts\AirConditioner\index.ts", "TypeScript", 0, 7, 0, 0, 0, 0, 1, 8
"f:\研奇\dashboard-view\src\packages\components\Charts\Devices\Door\config.ts", "TypeScript", 0, 17, 0, 0, 0, 0, 3, 20
"f:\研奇\dashboard-view\src\packages\components\Charts\Devices\Door\config.vue", "Vue", 25, 0, 0, 0, 0, 0, 5, 30
"f:\研奇\dashboard-view\src\packages\components\Charts\Devices\Door\index.ts", "TypeScript", 0, 14, 0, 0, 0, 0, 1, 15
"f:\研奇\dashboard-view\src\packages\components\Charts\Devices\Door\index.vue", "Vue", 36, 0, 0, 0, 0, 0, 7, 43
"f:\研奇\dashboard-view\src\packages\components\Charts\Devices\HumanSensor\config.ts", "TypeScript", 0, 17, 0, 0, 0, 0, 3, 20
"f:\研奇\dashboard-view\src\packages\components\Charts\Devices\HumanSensor\config.vue", "Vue", 25, 0, 0, 0, 0, 0, 5, 30
"f:\研奇\dashboard-view\src\packages\components\Charts\Devices\HumanSensor\index.ts", "TypeScript", 0, 14, 0, 0, 0, 0, 1, 15
"f:\研奇\dashboard-view\src\packages\components\Charts\Devices\HumanSensor\index.vue", "Vue", 43, 0, 0, 0, 0, 0, 7, 50
"f:\研奇\dashboard-view\src\packages\components\Charts\Devices\Led\config.ts", "TypeScript", 0, 17, 0, 0, 0, 0, 4, 21
"f:\研奇\dashboard-view\src\packages\components\Charts\Devices\Led\config.vue", "Vue", 25, 0, 0, 0, 0, 0, 5, 30
"f:\研奇\dashboard-view\src\packages\components\Charts\Devices\Led\index.ts", "TypeScript", 0, 14, 0, 0, 0, 0, 1, 15
"f:\研奇\dashboard-view\src\packages\components\Charts\Devices\Led\index.vue", "Vue", 45, 0, 0, 0, 0, 0, 7, 52
"f:\研奇\dashboard-view\src\packages\components\Charts\Devices\MotorDevice\config.ts", "TypeScript", 0, 14, 0, 0, 0, 0, 3, 17
"f:\研奇\dashboard-view\src\packages\components\Charts\Devices\MotorDevice\config.vue", "Vue", 7, 0, 0, 0, 0, 0, 4, 11
"f:\研奇\dashboard-view\src\packages\components\Charts\Devices\MotorDevice\index.ts", "TypeScript", 0, 14, 0, 0, 0, 0, 1, 15
"f:\研奇\dashboard-view\src\packages\components\Charts\Devices\MotorDevice\index.vue", "Vue", 83, 0, 0, 0, 0, 0, 14, 97
"f:\研奇\dashboard-view\src\packages\components\Charts\Devices\Motor\config.ts", "TypeScript", 0, 17, 0, 0, 0, 0, 4, 21
"f:\研奇\dashboard-view\src\packages\components\Charts\Devices\Motor\config.vue", "Vue", 24, 0, 0, 0, 0, 0, 5, 29
"f:\研奇\dashboard-view\src\packages\components\Charts\Devices\Motor\index.ts", "TypeScript", 0, 14, 0, 0, 0, 0, 1, 15
"f:\研奇\dashboard-view\src\packages\components\Charts\Devices\Motor\index.vue", "Vue", 45, 0, 0, 0, 0, 0, 8, 53
"f:\研奇\dashboard-view\src\packages\components\Charts\Devices\WaterSensor\config.ts", "TypeScript", 0, 17, 0, 0, 0, 0, 3, 20
"f:\研奇\dashboard-view\src\packages\components\Charts\Devices\WaterSensor\config.vue", "Vue", 25, 0, 0, 0, 0, 0, 5, 30
"f:\研奇\dashboard-view\src\packages\components\Charts\Devices\WaterSensor\index.ts", "TypeScript", 0, 14, 0, 0, 0, 0, 1, 15
"f:\研奇\dashboard-view\src\packages\components\Charts\Devices\WaterSensor\index.vue", "Vue", 36, 0, 0, 0, 0, 0, 7, 43
"f:\研奇\dashboard-view\src\packages\components\Charts\Devices\index.ts", "TypeScript", 0, 13, 0, 0, 0, 0, 3, 16
"f:\研奇\dashboard-view\src\packages\components\Charts\Gauges\GaugeCommon\config.ts", "TypeScript", 0, 101, 0, 0, 0, 10, 6, 117
"f:\研奇\dashboard-view\src\packages\components\Charts\Gauges\GaugeCommon\config.vue", "Vue", 154, 0, 0, 0, 0, 2, 5, 161
"f:\研奇\dashboard-view\src\packages\components\Charts\Gauges\GaugeCommon\index.ts", "TypeScript", 0, 14, 0, 0, 0, 0, 2, 16
"f:\研奇\dashboard-view\src\packages\components\Charts\Gauges\GaugeCommon\index.vue", "Vue", 224, 0, 0, 0, 0, 0, 25, 249
"f:\研奇\dashboard-view\src\packages\components\Charts\Gauges\TemperatureChart\config.ts", "TypeScript", 0, 114, 0, 0, 0, 2, 4, 120
"f:\研奇\dashboard-view\src\packages\components\Charts\Gauges\TemperatureChart\config.vue", "Vue", 185, 0, 0, 0, 0, 4, 11, 200
"f:\研奇\dashboard-view\src\packages\components\Charts\Gauges\TemperatureChart\index.ts", "TypeScript", 0, 13, 0, 0, 0, 0, 2, 15
"f:\研奇\dashboard-view\src\packages\components\Charts\Gauges\TemperatureChart\index.vue", "Vue", 81, 0, 0, 0, 0, 0, 8, 89
"f:\研奇\dashboard-view\src\packages\components\Charts\Gauges\index.ts", "TypeScript", 0, 2, 0, 0, 0, 0, 2, 4
"f:\研奇\dashboard-view\src\packages\components\Charts\Lines\LineCommon\config.ts", "TypeScript", 0, 49, 0, 0, 0, 1, 4, 54
"f:\研奇\dashboard-view\src\packages\components\Charts\Lines\LineCommon\config.vue", "Vue", 70, 0, 0, 0, 0, 1, 4, 75
"f:\研奇\dashboard-view\src\packages\components\Charts\Lines\LineCommon\data.json", "JSON", 0, 0, 40, 0, 0, 0, 1, 41
"f:\研奇\dashboard-view\src\packages\components\Charts\Lines\LineCommon\index.ts", "TypeScript", 0, 14, 0, 0, 0, 0, 1, 15
"f:\研奇\dashboard-view\src\packages\components\Charts\Lines\LineCommon\index.vue", "Vue", 76, 0, 0, 0, 0, 0, 9, 85
"f:\研奇\dashboard-view\src\packages\components\Charts\Lines\index.ts", "TypeScript", 0, 2, 0, 0, 0, 0, 2, 4
"f:\研奇\dashboard-view\src\packages\components\Charts\Mores\DigitFrame\config.ts", "TypeScript", 0, 69, 0, 0, 0, 0, 5, 74
"f:\研奇\dashboard-view\src\packages\components\Charts\Mores\DigitFrame\config.vue", "Vue", 43, 0, 0, 0, 0, 0, 4, 47
"f:\研奇\dashboard-view\src\packages\components\Charts\Mores\DigitFrame\index.ts", "TypeScript", 0, 14, 0, 0, 0, 0, 1, 15
"f:\研奇\dashboard-view\src\packages\components\Charts\Mores\DigitFrame\index.vue", "Vue", 56, 0, 0, 0, 0, 0, 9, 65
"f:\研奇\dashboard-view\src\packages\components\Charts\Mores\Online\config.ts", "TypeScript", 0, 17, 0, 0, 0, 3, 2, 22
"f:\研奇\dashboard-view\src\packages\components\Charts\Mores\Online\config.vue", "Vue", 46, 0, 0, 0, 0, 0, 4, 50
"f:\研奇\dashboard-view\src\packages\components\Charts\Mores\Online\index.ts", "TypeScript", 0, 14, 0, 0, 0, 0, 1, 15
"f:\研奇\dashboard-view\src\packages\components\Charts\Mores\Online\index.vue", "Vue", 54, 0, 0, 0, 0, 0, 8, 62
"f:\研奇\dashboard-view\src\packages\components\Charts\Mores\index.ts", "TypeScript", 0, 3, 0, 0, 0, 0, 3, 6
"f:\研奇\dashboard-view\src\packages\components\Charts\index.d.ts", "TypeScript", 0, 24, 0, 0, 0, 1, 3, 28
"f:\研奇\dashboard-view\src\packages\components\Charts\index.ts", "TypeScript", 0, 6, 0, 0, 0, 0, 2, 8
"f:\研奇\dashboard-view\src\packages\components\Decorates\Borders\index.ts", "TypeScript", 0, 2, 0, 0, 0, 0, 4, 6
"f:\研奇\dashboard-view\src\packages\components\Decorates\Decorates\index.ts", "TypeScript", 0, 1, 0, 0, 0, 0, 3, 4
"f:\研奇\dashboard-view\src\packages\components\Decorates\Mores\Exit\config.ts", "TypeScript", 0, 14, 0, 0, 0, 0, 3, 17
"f:\研奇\dashboard-view\src\packages\components\Decorates\Mores\Exit\config.vue", "Vue", 4, 0, 0, 0, 0, 0, 4, 8
"f:\研奇\dashboard-view\src\packages\components\Decorates\Mores\Exit\index.ts", "TypeScript", 0, 13, 0, 0, 0, 0, 2, 15
"f:\研奇\dashboard-view\src\packages\components\Decorates\Mores\Exit\index.vue", "Vue", 77, 0, 0, 0, 0, 0, 5, 82
"f:\研奇\dashboard-view\src\packages\components\Decorates\Mores\FullScreen\config.ts", "TypeScript", 0, 16, 0, 0, 0, 0, 3, 19
"f:\研奇\dashboard-view\src\packages\components\Decorates\Mores\FullScreen\config.vue", "Vue", 26, 0, 0, 0, 0, 0, 3, 29
"f:\研奇\dashboard-view\src\packages\components\Decorates\Mores\FullScreen\index.ts", "TypeScript", 0, 13, 0, 0, 0, 0, 2, 15
"f:\研奇\dashboard-view\src\packages\components\Decorates\Mores\FullScreen\index.vue", "Vue", 102, 0, 0, 0, 0, 0, 10, 112
"f:\研奇\dashboard-view\src\packages\components\Decorates\Mores\Square\config.ts", "TypeScript", 0, 14, 0, 0, 0, 0, 2, 16
"f:\研奇\dashboard-view\src\packages\components\Decorates\Mores\Square\config.vue", "Vue", 52, 0, 0, 0, 0, 0, 4, 56
"f:\研奇\dashboard-view\src\packages\components\Decorates\Mores\Square\index.ts", "TypeScript", 0, 13, 0, 0, 0, 0, 1, 14
"f:\研奇\dashboard-view\src\packages\components\Decorates\Mores\Square\index.vue", "Vue", 35, 0, 0, 0, 0, 0, 5, 40
"f:\研奇\dashboard-view\src\packages\components\Decorates\Mores\TimeCommon\config.ts", "TypeScript", 0, 31, 0, 0, 0, 2, 6, 39
"f:\研奇\dashboard-view\src\packages\components\Decorates\Mores\TimeCommon\config.vue", "Vue", 97, 0, 0, 0, 0, 0, 3, 100
"f:\研奇\dashboard-view\src\packages\components\Decorates\Mores\TimeCommon\index.ts", "TypeScript", 0, 13, 0, 0, 0, 0, 2, 15
"f:\研奇\dashboard-view\src\packages\components\Decorates\Mores\TimeCommon\index.vue", "Vue", 88, 0, 0, 0, 0, 0, 6, 94
"f:\研奇\dashboard-view\src\packages\components\Decorates\Mores\index.ts", "TypeScript", 0, 10, 0, 0, 0, 0, 2, 12
"f:\研奇\dashboard-view\src\packages\components\Decorates\Three\index.ts", "TypeScript", 0, 1, 0, 0, 0, 0, 3, 4
"f:\研奇\dashboard-view\src\packages\components\Decorates\index.d.ts", "TypeScript", 0, 12, 0, 0, 0, 0, 1, 13
"f:\研奇\dashboard-view\src\packages\components\Decorates\index.ts", "TypeScript", 0, 5, 0, 0, 0, 0, 2, 7
"f:\研奇\dashboard-view\src\packages\components\Icons\Common\index.ts", "TypeScript", 0, 82, 0, 0, 0, 0, 3, 85
"f:\研奇\dashboard-view\src\packages\components\Icons\Default\Icon\config.ts", "TypeScript", 0, 17, 0, 0, 0, 1, 3, 21
"f:\研奇\dashboard-view\src\packages\components\Icons\Default\Icon\config.vue", "Vue", 47, 0, 0, 0, 0, 0, 4, 51
"f:\研奇\dashboard-view\src\packages\components\Icons\Default\Icon\index.ts", "TypeScript", 0, 13, 0, 0, 0, 0, 2, 15
"f:\研奇\dashboard-view\src\packages\components\Icons\Default\Icon\index.vue", "Vue", 27, 0, 0, 0, 0, 0, 5, 32
"f:\研奇\dashboard-view\src\packages\components\Icons\MaterialLine\index.ts", "TypeScript", 0, 43, 0, 0, 0, 0, 3, 46
"f:\研奇\dashboard-view\src\packages\components\Icons\Weather\index.ts", "TypeScript", 0, 51, 0, 0, 0, 0, 3, 54
"f:\研奇\dashboard-view\src\packages\components\Icons\index.d.ts", "TypeScript", 0, 12, 0, 0, 0, 0, 2, 14
"f:\研奇\dashboard-view\src\packages\components\Icons\index.ts", "TypeScript", 0, 4, 0, 0, 0, 0, 2, 6
"f:\研奇\dashboard-view\src\packages\components\Informations\Inputs\InputsInput\config.ts", "TypeScript", 0, 19, 0, 0, 0, 3, 2, 24
"f:\研奇\dashboard-view\src\packages\components\Informations\Inputs\InputsInput\config.vue", "Vue", 18, 0, 0, 0, 0, 0, 0, 18
"f:\研奇\dashboard-view\src\packages\components\Informations\Inputs\InputsInput\index.ts", "TypeScript", 0, 13, 0, 0, 0, 0, 1, 14
"f:\研奇\dashboard-view\src\packages\components\Informations\Inputs\InputsInput\index.vue", "Vue", 52, 0, 0, 0, 0, 0, 13, 65
"f:\研奇\dashboard-view\src\packages\components\Informations\Inputs\InputsInput\interact.ts", "TypeScript", 0, 21, 0, 0, 0, 3, 4, 28
"f:\研奇\dashboard-view\src\packages\components\Informations\Inputs\Slider\config.ts", "TypeScript", 0, 21, 0, 0, 0, 0, 3, 24
"f:\研奇\dashboard-view\src\packages\components\Informations\Inputs\Slider\config.vue", "Vue", 37, 0, 0, 0, 0, 0, 4, 41
"f:\研奇\dashboard-view\src\packages\components\Informations\Inputs\Slider\index.ts", "TypeScript", 0, 13, 0, 0, 0, 0, 1, 14
"f:\研奇\dashboard-view\src\packages\components\Informations\Inputs\Slider\index.vue", "Vue", 61, 0, 0, 0, 0, 0, 8, 69
"f:\研奇\dashboard-view\src\packages\components\Informations\Inputs\index.ts", "TypeScript", 0, 3, 0, 0, 0, 0, 3, 6
"f:\研奇\dashboard-view\src\packages\components\Informations\Mores\ImageCarousel\config.ts", "TypeScript", 0, 29, 0, 0, 0, 13, 3, 45
"f:\研奇\dashboard-view\src\packages\components\Informations\Mores\ImageCarousel\config.vue", "Vue", 163, 0, 0, 0, 0, 1, 5, 169
"f:\研奇\dashboard-view\src\packages\components\Informations\Mores\ImageCarousel\index.ts", "TypeScript", 0, 13, 0, 0, 0, 0, 2, 15
"f:\研奇\dashboard-view\src\packages\components\Informations\Mores\ImageCarousel\index.vue", "Vue", 73, 0, 0, 0, 0, 0, 6, 79
"f:\研奇\dashboard-view\src\packages\components\Informations\Mores\Image\config.ts", "TypeScript", 0, 16, 0, 0, 0, 3, 3, 22
"f:\研奇\dashboard-view\src\packages\components\Informations\Mores\Image\config.vue", "Vue", 64, 0, 0, 0, 0, 0, 4, 68
"f:\研奇\dashboard-view\src\packages\components\Informations\Mores\Image\index.ts", "TypeScript", 0, 13, 0, 0, 0, 0, 2, 15
"f:\研奇\dashboard-view\src\packages\components\Informations\Mores\Image\index.vue", "Vue", 51, 0, 0, 0, 0, 0, 8, 59
"f:\研奇\dashboard-view\src\packages\components\Informations\Mores\index.ts", "TypeScript", 0, 3, 0, 0, 0, 0, 2, 5
"f:\研奇\dashboard-view\src\packages\components\Informations\Texts\TextBarrage\config.ts", "TypeScript", 0, 35, 0, 0, 0, 3, 5, 43
"f:\研奇\dashboard-view\src\packages\components\Informations\Texts\TextBarrage\config.vue", "Vue", 84, 0, 0, 0, 0, 0, 6, 90
"f:\研奇\dashboard-view\src\packages\components\Informations\Texts\TextBarrage\index.ts", "TypeScript", 0, 13, 0, 0, 0, 0, 2, 15
"f:\研奇\dashboard-view\src\packages\components\Informations\Texts\TextBarrage\index.vue", "Vue", 92, 0, 0, 0, 0, 0, 11, 103
"f:\研奇\dashboard-view\src\packages\components\Informations\Texts\TextCommon\config.ts", "TypeScript", 0, 42, 0, 0, 0, 2, 9, 53
"f:\研奇\dashboard-view\src\packages\components\Informations\Texts\TextCommon\config.vue", "Vue", 106, 0, 0, 0, 0, 14, 9, 129
"f:\研奇\dashboard-view\src\packages\components\Informations\Texts\TextCommon\index.ts", "TypeScript", 0, 13, 0, 0, 0, 0, 2, 15
"f:\研奇\dashboard-view\src\packages\components\Informations\Texts\TextCommon\index.vue", "Vue", 80, 0, 0, 0, 0, 0, 11, 91
"f:\研奇\dashboard-view\src\packages\components\Informations\Texts\TextGradient\config.ts", "TypeScript", 0, 18, 0, 0, 0, 0, 3, 21
"f:\研奇\dashboard-view\src\packages\components\Informations\Texts\TextGradient\config.vue", "Vue", 42, 0, 0, 0, 0, 0, 4, 46
"f:\研奇\dashboard-view\src\packages\components\Informations\Texts\TextGradient\index.ts", "TypeScript", 0, 13, 0, 0, 0, 0, 2, 15
"f:\研奇\dashboard-view\src\packages\components\Informations\Texts\TextGradient\index.vue", "Vue", 48, 0, 0, 0, 0, 0, 7, 55
"f:\研奇\dashboard-view\src\packages\components\Informations\Texts\index.ts", "TypeScript", 0, 4, 0, 0, 0, 0, 2, 6
"f:\研奇\dashboard-view\src\packages\components\Informations\index.d.ts", "TypeScript", 0, 12, 0, 0, 0, 1, 1, 14
"f:\研奇\dashboard-view\src\packages\components\Informations\index.ts", "TypeScript", 0, 4, 0, 0, 0, 0, 2, 6
"f:\研奇\dashboard-view\src\packages\components\Photos\Private\index.ts", "TypeScript", 0, 78, 0, 0, 0, 7, 7, 92
"f:\研奇\dashboard-view\src\packages\components\Photos\Share\index.ts", "TypeScript", 0, 17, 0, 0, 0, 3, 4, 24
"f:\研奇\dashboard-view\src\packages\components\Photos\index.d.ts", "TypeScript", 0, 8, 0, 0, 0, 0, 2, 10
"f:\研奇\dashboard-view\src\packages\components\Photos\index.ts", "TypeScript", 0, 3, 0, 0, 0, 0, 2, 5
"f:\研奇\dashboard-view\src\packages\components\Tables\Tables\TableList\config.ts", "TypeScript", 0, 25, 0, 0, 0, 9, 3, 37
"f:\研奇\dashboard-view\src\packages\components\Tables\Tables\TableList\config.vue", "Vue", 90, 0, 0, 0, 0, 0, 6, 96
"f:\研奇\dashboard-view\src\packages\components\Tables\Tables\TableList\data.json", "JSON", 0, 0, 14, 0, 0, 0, 1, 15
"f:\研奇\dashboard-view\src\packages\components\Tables\Tables\TableList\index.ts", "TypeScript", 0, 13, 0, 0, 0, 0, 2, 15
"f:\研奇\dashboard-view\src\packages\components\Tables\Tables\TableList\index.vue", "Vue", 232, 0, 0, 0, 0, 0, 28, 260
"f:\研奇\dashboard-view\src\packages\components\Tables\Tables\TableScrollBoard\config.ts", "TypeScript", 0, 24, 0, 0, 0, 0, 3, 27
"f:\研奇\dashboard-view\src\packages\components\Tables\Tables\TableScrollBoard\config.vue", "Vue", 102, 0, 0, 0, 0, 0, 8, 110
"f:\研奇\dashboard-view\src\packages\components\Tables\Tables\TableScrollBoard\data.json", "JSON", 0, 0, 12, 0, 0, 0, 1, 13
"f:\研奇\dashboard-view\src\packages\components\Tables\Tables\TableScrollBoard\index.ts", "TypeScript", 0, 13, 0, 0, 0, 0, 2, 15
"f:\研奇\dashboard-view\src\packages\components\Tables\Tables\TableScrollBoard\index.vue", "Vue", 354, 0, 0, 0, 0, 0, 35, 389
"f:\研奇\dashboard-view\src\packages\components\Tables\Tables\TablesBasic\config.ts", "TypeScript", 0, 33, 0, 0, 0, 0, 3, 36
"f:\研奇\dashboard-view\src\packages\components\Tables\Tables\TablesBasic\config.vue", "Vue", 157, 0, 0, 0, 0, 0, 6, 163
"f:\研奇\dashboard-view\src\packages\components\Tables\Tables\TablesBasic\data.json", "JSON", 0, 0, 60, 0, 0, 0, 1, 61
"f:\研奇\dashboard-view\src\packages\components\Tables\Tables\TablesBasic\index.ts", "TypeScript", 0, 13, 0, 0, 0, 0, 2, 15
"f:\研奇\dashboard-view\src\packages\components\Tables\Tables\TablesBasic\index.vue", "Vue", 85, 0, 0, 0, 0, 0, 11, 96
"f:\研奇\dashboard-view\src\packages\components\Tables\Tables\index.ts", "TypeScript", 0, 4, 0, 0, 0, 0, 2, 6
"f:\研奇\dashboard-view\src\packages\components\Tables\index.d.ts", "TypeScript", 0, 6, 0, 0, 0, 0, 1, 7
"f:\研奇\dashboard-view\src\packages\components\Tables\index.ts", "TypeScript", 0, 2, 0, 0, 0, 0, 2, 4
"f:\研奇\dashboard-view\src\packages\index.d.ts", "TypeScript", 0, 160, 0, 0, 0, 43, 22, 225
"f:\研奇\dashboard-view\src\packages\index.ts", "TypeScript", 0, 88, 0, 0, 0, 29, 10, 127
"f:\研奇\dashboard-view\src\packages\public\chart.ts", "TypeScript", 0, 22, 0, 0, 0, 22, 5, 49
"f:\研奇\dashboard-view\src\packages\public\index.ts", "TypeScript", 0, 2, 0, 0, 0, 0, 1, 3
"f:\研奇\dashboard-view\src\packages\public\publicConfig.ts", "TypeScript", 0, 108, 0, 0, 0, 28, 8, 144
"f:\研奇\dashboard-view\src\page\Home\components\Alarm\index.ts", "TypeScript", 0, 2, 0, 0, 0, 0, 1, 3
"f:\研奇\dashboard-view\src\page\Home\components\Alarm\index.vue", "Vue", 30, 0, 0, 0, 0, 0, 5, 35
"f:\研奇\dashboard-view\src\page\Home\components\Dnum\index.ts", "TypeScript", 0, 2, 0, 0, 0, 0, 1, 3
"f:\研奇\dashboard-view\src\page\Home\components\Dnum\index.vue", "Vue", 28, 0, 0, 0, 0, 0, 6, 34
"f:\研奇\dashboard-view\src\page\Home\components\Health\index.ts", "TypeScript", 0, 2, 0, 0, 0, 0, 2, 4
"f:\研奇\dashboard-view\src\page\Home\components\Health\index.vue", "Vue", 19, 0, 0, 0, 0, 0, 4, 23
"f:\研奇\dashboard-view\src\page\Home\components\Porperty\index.ts", "TypeScript", 0, 2, 0, 0, 0, 0, 1, 3
"f:\研奇\dashboard-view\src\page\Home\components\Porperty\index.vue", "Vue", 16, 0, 0, 0, 0, 7, 5, 28
"f:\研奇\dashboard-view\src\page\Home\components\Statics\index.ts", "TypeScript", 0, 2, 0, 0, 0, 0, 1, 3
"f:\研奇\dashboard-view\src\page\Home\components\Statics\index.vue", "Vue", 40, 0, 0, 0, 0, 0, 5, 45
"f:\研奇\dashboard-view\src\page\Home\index.ts", "TypeScript", 0, 2, 0, 0, 0, 0, 1, 3
"f:\研奇\dashboard-view\src\page\Home\index.vue", "Vue", 45, 0, 0, 0, 0, 0, 3, 48
"f:\研奇\dashboard-view\src\page\IP\components\Addr\index.ts", "TypeScript", 0, 2, 0, 0, 0, 0, 1, 3
"f:\研奇\dashboard-view\src\page\IP\components\Addr\index.vue", "Vue", 18, 0, 0, 0, 0, 1, 4, 23
"f:\研奇\dashboard-view\src\page\IP\components\Dnum\index.ts", "TypeScript", 0, 2, 0, 0, 0, 0, 1, 3
"f:\研奇\dashboard-view\src\page\IP\components\Dnum\index.vue", "Vue", 0, 0, 0, 0, 0, 0, 1, 1
"f:\研奇\dashboard-view\src\page\IP\components\NetNum\index.ts", "TypeScript", 0, 2, 0, 0, 0, 0, 1, 3
"f:\研奇\dashboard-view\src\page\IP\components\NetNum\index.vue", "Vue", 22, 0, 0, 0, 0, 0, 5, 27
"f:\研奇\dashboard-view\src\page\IP\components\Porperty\index.ts", "TypeScript", 0, 2, 0, 0, 0, 0, 1, 3
"f:\研奇\dashboard-view\src\page\IP\components\Porperty\index.vue", "Vue", 0, 0, 0, 0, 0, 0, 1, 1
"f:\研奇\dashboard-view\src\page\IP\components\Statics\index.ts", "TypeScript", 0, 2, 0, 0, 0, 0, 1, 3
"f:\研奇\dashboard-view\src\page\IP\components\Statics\index.vue", "Vue", 40, 0, 0, 0, 0, 0, 5, 45
"f:\研奇\dashboard-view\src\page\IP\components\Status\index.ts", "TypeScript", 0, 2, 0, 0, 0, 0, 1, 3
"f:\研奇\dashboard-view\src\page\IP\components\Status\index.vue", "Vue", 24, 0, 0, 0, 0, 0, 5, 29
"f:\研奇\dashboard-view\src\page\IP\index.ts", "TypeScript", 0, 2, 0, 0, 0, 0, 1, 3
"f:\研奇\dashboard-view\src\page\IP\index.vue", "Vue", 46, 0, 0, 0, 0, 0, 3, 49
"f:\研奇\dashboard-view\src\page\ObjectManage\LocalObject\components\DeviceInfo\index.ts", "TypeScript", 0, 2, 0, 0, 0, 0, 1, 3
"f:\研奇\dashboard-view\src\page\ObjectManage\LocalObject\components\DeviceInfo\index.vue", "Vue", 171, 0, 0, 0, 0, 0, 19, 190
"f:\研奇\dashboard-view\src\page\ObjectManage\LocalObject\components\ParamList\index.ts", "TypeScript", 0, 2, 0, 0, 0, 0, 1, 3
"f:\研奇\dashboard-view\src\page\ObjectManage\LocalObject\components\ParamList\index.vue", "Vue", 181, 0, 0, 0, 0, 0, 22, 203
"f:\研奇\dashboard-view\src\page\ObjectManage\LocalObject\index.ts", "TypeScript", 0, 2, 0, 0, 0, 0, 1, 3
"f:\研奇\dashboard-view\src\page\ObjectManage\LocalObject\index.vue", "Vue", 134, 0, 0, 0, 0, 0, 21, 155
"f:\研奇\dashboard-view\src\page\ObjectManage\Modbus\components\LinkParams\index.ts", "TypeScript", 0, 2, 0, 0, 0, 0, 1, 3
"f:\研奇\dashboard-view\src\page\ObjectManage\Modbus\components\LinkParams\index.vue", "Vue", 71, 0, 0, 0, 0, 0, 6, 77
"f:\研奇\dashboard-view\src\page\ObjectManage\Modbus\components\LinkParams\option.ts", "TypeScript", 0, 26, 0, 0, 0, 0, 7, 33
"f:\研奇\dashboard-view\src\page\ObjectManage\Modbus\index.ts", "TypeScript", 0, 2, 0, 0, 0, 0, 1, 3
"f:\研奇\dashboard-view\src\page\ObjectManage\Modbus\index.vue", "Vue", 350, 0, 0, 0, 0, 0, 34, 384
"f:\研奇\dashboard-view\src\page\ObjectManage\Modbus\modal\ConfigModal\index.ts", "TypeScript", 0, 2, 0, 0, 0, 0, 1, 3
"f:\研奇\dashboard-view\src\page\ObjectManage\Modbus\modal\ConfigModal\index.vue", "Vue", 258, 0, 0, 0, 0, 0, 20, 278
"f:\研奇\dashboard-view\src\page\ObjectManage\Modbus\modal\ModbusModal\index.ts", "TypeScript", 0, 2, 0, 0, 0, 0, 1, 3
"f:\研奇\dashboard-view\src\page\ObjectManage\Modbus\modal\ModbusModal\index.vue", "Vue", 188, 0, 0, 0, 0, 0, 17, 205
"f:\研奇\dashboard-view\src\page\ObjectManage\Modbus\utils\utils.ts", "TypeScript", 0, 56, 0, 0, 0, 0, 5, 61
"f:\研奇\dashboard-view\src\page\ObjectManage\RemoteObject\components\ObjectList\index.ts", "TypeScript", 0, 2, 0, 0, 0, 0, 1, 3
"f:\研奇\dashboard-view\src\page\ObjectManage\RemoteObject\components\ObjectList\index.vue", "Vue", 155, 0, 0, 0, 0, 0, 31, 186
"f:\研奇\dashboard-view\src\page\ObjectManage\RemoteObject\index.ts", "TypeScript", 0, 2, 0, 0, 0, 0, 1, 3
"f:\研奇\dashboard-view\src\page\ObjectManage\RemoteObject\index.vue", "Vue", 241, 0, 0, 0, 0, 0, 35, 276
"f:\研奇\dashboard-view\src\page\ObjectManage\RemoteObject\modal\BACnet\index.ts", "TypeScript", 0, 2, 0, 0, 0, 0, 1, 3
"f:\研奇\dashboard-view\src\page\ObjectManage\RemoteObject\modal\BACnet\index.vue", "Vue", 36, 0, 0, 0, 0, 0, 4, 40
"f:\研奇\dashboard-view\src\page\ObjectManage\RemoteObject\modal\DeviceSetModal\index.ts", "TypeScript", 0, 2, 0, 0, 0, 0, 1, 3
"f:\研奇\dashboard-view\src\page\ObjectManage\RemoteObject\modal\DeviceSetModal\index.vue", "Vue", 184, 0, 0, 0, 0, 0, 25, 209
"f:\研奇\dashboard-view\src\page\ObjectManage\RemoteObject\modal\ModbusRTU\index.ts", "TypeScript", 0, 2, 0, 0, 0, 0, 1, 3
"f:\研奇\dashboard-view\src\page\ObjectManage\RemoteObject\modal\ModbusRTU\index.vue", "Vue", 50, 0, 0, 0, 0, 0, 5, 55
"f:\研奇\dashboard-view\src\page\ObjectManage\RemoteObject\modal\ObjectSetModal\index.ts", "TypeScript", 0, 0, 0, 0, 0, 0, 1, 1
"f:\研奇\dashboard-view\src\page\ObjectManage\RemoteObject\modal\ObjectSetModal\index.vue", "Vue", 0, 0, 0, 0, 0, 0, 1, 1
"f:\研奇\dashboard-view\src\page\ObjectManage\RemoteObject\utils\utils.ts", "TypeScript", 0, 133, 0, 0, 0, 0, 18, 151
"f:\研奇\dashboard-view\src\page\style\card.scss", "SCSS", 0, 0, 0, 23, 0, 0, 3, 26
"f:\研奇\dashboard-view\src\page\style\table.scss", "SCSS", 0, 0, 0, 59, 0, 0, 9, 68
"f:\研奇\dashboard-view\src\page\untils\options.ts", "TypeScript", 0, 10, 0, 0, 0, 1, 1, 12
"f:\研奇\dashboard-view\src\page\untils\type.ts", "TypeScript", 0, 12, 0, 0, 0, 0, 3, 15
"f:\研奇\dashboard-view\src\plugins\customComponents.ts", "TypeScript", 0, 9, 0, 0, 0, 4, 2, 15
"f:\研奇\dashboard-view\src\plugins\directives.ts", "TypeScript", 0, 8, 0, 0, 0, 7, 3, 18
"f:\研奇\dashboard-view\src\plugins\icon.ts", "TypeScript", 0, 234, 0, 0, 0, 89, 6, 329
"f:\研奇\dashboard-view\src\plugins\index.ts", "TypeScript", 0, 5, 0, 0, 0, 0, 1, 6
"f:\研奇\dashboard-view\src\plugins\initFunction.ts", "TypeScript", 0, 5, 0, 0, 0, 4, 0, 9
"f:\研奇\dashboard-view\src\plugins\naive.ts", "TypeScript", 0, 213, 0, 0, 0, 0, 3, 216
"f:\研奇\dashboard-view\src\router\base.ts", "TypeScript", 0, 75, 0, 0, 0, 0, 7, 82
"f:\研奇\dashboard-view\src\router\constant.ts", "TypeScript", 0, 5, 0, 0, 0, 0, 5, 10
"f:\研奇\dashboard-view\src\router\index.ts", "TypeScript", 0, 37, 0, 0, 0, 1, 7, 45
"f:\研奇\dashboard-view\src\router\modules\chart.route.ts", "TypeScript", 0, 16, 0, 0, 0, 1, 4, 21
"f:\研奇\dashboard-view\src\router\modules\edit.route.ts", "TypeScript", 0, 15, 0, 0, 0, 1, 4, 20
"f:\研奇\dashboard-view\src\router\modules\index.ts", "TypeScript", 0, 10, 0, 0, 0, 0, 1, 11
"f:\研奇\dashboard-view\src\router\modules\preview.route.ts", "TypeScript", 0, 15, 0, 0, 0, 1, 4, 20
"f:\研奇\dashboard-view\src\router\modules\project.router.ts", "TypeScript", 0, 82, 0, 0, 0, 1, 4, 87
"f:\研奇\dashboard-view\src\router\router-guards.ts", "TypeScript", 0, 24, 0, 0, 0, 12, 5, 41
"f:\研奇\dashboard-view\src\router\types.ts", "TypeScript", 0, 27, 0, 0, 0, 9, 5, 41
"f:\研奇\dashboard-view\src\settings\animations\index.ts", "TypeScript", 0, 57, 0, 0, 0, 0, 1, 58
"f:\研奇\dashboard-view\src\settings\chartThemes\global.theme.json", "JSON", 0, 0, 111, 0, 0, 0, 0, 111
"f:\研奇\dashboard-view\src\settings\chartThemes\index.ts", "TypeScript", 0, 57, 0, 0, 0, 7, 13, 77
"f:\研奇\dashboard-view\src\settings\chartThemes\themes\chalk.json", "JSON", 0, 0, 13, 0, 0, 0, 0, 13
"f:\研奇\dashboard-view\src\settings\chartThemes\themes\customed.json", "JSON", 0, 0, 14, 0, 0, 0, 0, 14
"f:\研奇\dashboard-view\src\settings\chartThemes\themes\dark.json", "JSON", 0, 0, 14, 0, 0, 0, 0, 14
"f:\研奇\dashboard-view\src\settings\chartThemes\themes\essos.json", "JSON", 0, 0, 11, 0, 0, 0, 0, 11
"f:\研奇\dashboard-view\src\settings\chartThemes\themes\macarons.json", "JSON", 0, 0, 25, 0, 0, 0, 0, 25
"f:\研奇\dashboard-view\src\settings\chartThemes\themes\purple-passion.json", "JSON", 0, 0, 11, 0, 0, 0, 0, 11
"f:\研奇\dashboard-view\src\settings\chartThemes\themes\roma.json", "JSON", 0, 0, 25, 0, 0, 0, 0, 25
"f:\研奇\dashboard-view\src\settings\chartThemes\themes\shine.json", "JSON", 0, 0, 13, 0, 0, 0, 0, 13
"f:\研奇\dashboard-view\src\settings\chartThemes\themes\vintage.json", "JSON", 0, 0, 15, 0, 0, 0, 0, 15
"f:\研奇\dashboard-view\src\settings\chartThemes\themes\walden.json", "JSON", 0, 0, 11, 0, 0, 0, 0, 11
"f:\研奇\dashboard-view\src\settings\chartThemes\themes\westeros.json", "JSON", 0, 0, 11, 0, 0, 0, 0, 11
"f:\研奇\dashboard-view\src\settings\chartThemes\themes\wonderland.json", "JSON", 0, 0, 11, 0, 0, 0, 0, 11
"f:\研奇\dashboard-view\src\settings\designColor.json", "JSON", 0, 0, 3677, 0, 0, 0, 1, 3678
"f:\研奇\dashboard-view\src\settings\designColorRecommend.json", "JSON", 0, 0, 30, 0, 0, 0, 1, 31
"f:\研奇\dashboard-view\src\settings\designSetting.ts", "TypeScript", 0, 33, 0, 0, 0, 22, 20, 75
"f:\研奇\dashboard-view\src\settings\pathConst.ts", "TypeScript", 0, 3, 0, 0, 0, 4, 4, 11
"f:\研奇\dashboard-view\src\settings\systemSetting.ts", "TypeScript", 0, 10, 0, 0, 0, 8, 1, 19
"f:\研奇\dashboard-view\src\store\index.ts", "TypeScript", 0, 7, 0, 0, 0, 0, 4, 11
"f:\研奇\dashboard-view\src\store\modules\chartEditStore\chartEditStore.d.ts", "TypeScript", 0, 151, 0, 0, 0, 60, 16, 227
"f:\研奇\dashboard-view\src\store\modules\chartEditStore\chartEditStore.ts", "TypeScript", 0, 896, 0, 0, 0, 187, 48, 1131
"f:\研奇\dashboard-view\src\store\modules\chartHistoryStore\chartHistoryDefine.ts", "TypeScript", 0, 21, 0, 0, 0, 0, 3, 24
"f:\研奇\dashboard-view\src\store\modules\chartHistoryStore\chartHistoryStore.d.ts", "TypeScript", 0, 45, 0, 0, 0, 26, 8, 79
"f:\研奇\dashboard-view\src\store\modules\chartHistoryStore\chartHistoryStore.ts", "TypeScript", 0, 153, 0, 0, 0, 34, 2, 189
"f:\研奇\dashboard-view\src\store\modules\chartLayoutStore\chartLayoutStore.d.ts", "TypeScript", 0, 26, 0, 0, 0, 7, 4, 37
"f:\研奇\dashboard-view\src\store\modules\chartLayoutStore\chartLayoutStore.ts", "TypeScript", 0, 67, 0, 0, 0, 12, 5, 84
"f:\研奇\dashboard-view\src\store\modules\designStore\designStore.d.ts", "TypeScript", 0, 14, 0, 0, 0, 3, 3, 20
"f:\研奇\dashboard-view\src\store\modules\designStore\designStore.ts", "TypeScript", 0, 42, 0, 0, 0, 5, 4, 51
"f:\研奇\dashboard-view\src\store\modules\langStore\langStore.d.ts", "TypeScript", 0, 4, 0, 0, 0, 1, 1, 6
"f:\研奇\dashboard-view\src\store\modules\langStore\langStore.ts", "TypeScript", 0, 32, 0, 0, 0, 1, 4, 37
"f:\研奇\dashboard-view\src\store\modules\packagesStore\packagesStore.d.ts", "TypeScript", 0, 7, 0, 0, 0, 0, 3, 10
"f:\研奇\dashboard-view\src\store\modules\packagesStore\packagesStore.ts", "TypeScript", 0, 30, 0, 0, 0, 1, 2, 33
"f:\研奇\dashboard-view\src\store\modules\settingStore\settingStore.d.ts", "TypeScript", 0, 22, 0, 0, 0, 7, 3, 32
"f:\研奇\dashboard-view\src\store\modules\settingStore\settingStore.ts", "TypeScript", 0, 51, 0, 0, 0, 1, 3, 55
"f:\研奇\dashboard-view\src\styles\common\_dark.scss", "SCSS", 0, 0, 0, 30, 0, 11, 3, 44
"f:\研奇\dashboard-view\src\styles\common\_light.scss", "SCSS", 0, 0, 0, 28, 0, 8, 2, 38
"f:\研奇\dashboard-view\src\styles\common\animation.scss", "SCSS", 0, 0, 0, 57, 0, 4, 8, 69
"f:\研奇\dashboard-view\src\styles\common\format.scss", "SCSS", 0, 0, 0, 18, 0, 3, 3, 24
"f:\研奇\dashboard-view\src\styles\common\mixins\config.scss", "SCSS", 0, 0, 0, 4, 0, 0, 1, 5
"f:\研奇\dashboard-view\src\styles\common\mixins\function.scss", "SCSS", 0, 0, 0, 3, 0, 0, 0, 3
"f:\研奇\dashboard-view\src\styles\common\mixins\mixins.scss", "SCSS", 0, 0, 0, 70, 0, 3, 12, 85
"f:\研奇\dashboard-view\src\styles\common\style.scss", "SCSS", 0, 0, 0, 93, 0, 14, 21, 128
"f:\研奇\dashboard-view\src\styles\common\theme.scss", "SCSS", 0, 0, 0, 7, 0, 2, 2, 11
"f:\研奇\dashboard-view\src\styles\common\var.scss", "SCSS", 0, 0, 0, 75, 0, 16, 14, 105
"f:\研奇\dashboard-view\src\styles\pages\index.scss", "SCSS", 0, 0, 0, 12, 0, 2, 1, 15
"f:\研奇\dashboard-view\src\svg\SVG_ICON.ts", "TypeScript", 0, 112, 0, 0, 0, 0, 2, 114
"f:\研奇\dashboard-view\src\svg\icons\Bacnet-line.svg", "XML", 0, 0, 0, 0, 16, 0, 1, 17
"f:\研奇\dashboard-view\src\svg\icons\Bacnet-nomal.svg", "XML", 0, 0, 0, 0, 1, 0, 0, 1
"f:\研奇\dashboard-view\src\svg\icons\Visualization-df.svg", "XML", 0, 0, 0, 0, 12, 0, 1, 13
"f:\研奇\dashboard-view\src\svg\icons\Visualization-sp.svg", "XML", 0, 0, 0, 0, 19, 0, 1, 20
"f:\研奇\dashboard-view\src\svg\icons\XPlay.svg", "XML", 0, 0, 0, 0, 8, 0, 0, 8
"f:\研奇\dashboard-view\src\svg\icons\_doorClose_SP.svg", "XML", 0, 0, 0, 0, 23, 0, 0, 23
"f:\研奇\dashboard-view\src\svg\icons\_doorOpen_SP.svg", "XML", 0, 0, 0, 0, 27, 0, 0, 27
"f:\研奇\dashboard-view\src\svg\icons\_dry_TF.svg", "XML", 0, 0, 0, 0, 4, 0, 0, 4
"f:\研奇\dashboard-view\src\svg\icons\_dry_TL.svg", "XML", 0, 0, 0, 0, 5, 0, 0, 5
"f:\研奇\dashboard-view\src\svg\icons\_edit_deft.svg", "XML", 0, 0, 0, 0, 1, 0, 0, 1
"f:\研奇\dashboard-view\src\svg\icons\_exit_deft.svg", "XML", 0, 0, 0, 0, 1, 0, 0, 1
"f:\研奇\dashboard-view\src\svg\icons\_fan2_TF.svg", "XML", 0, 0, 0, 0, 8, 0, 0, 8
"f:\研奇\dashboard-view\src\svg\icons\_fan2_TL.svg", "XML", 0, 0, 0, 0, 8, 0, 0, 8
"f:\研奇\dashboard-view\src\svg\icons\_graphic_df.svg", "XML", 0, 0, 0, 0, 12, 0, 0, 12
"f:\研奇\dashboard-view\src\svg\icons\_graphic_s.svg", "XML", 0, 0, 0, 0, 30, 0, 0, 30
"f:\研奇\dashboard-view\src\svg\icons\_green_alarm.svg", "XML", 0, 0, 0, 0, 22, 0, 1, 23
"f:\研奇\dashboard-view\src\svg\icons\_humidify_TF.svg", "XML", 0, 0, 0, 0, 4, 0, 0, 4
"f:\研奇\dashboard-view\src\svg\icons\_humidify_TL.svg", "XML", 0, 0, 0, 0, 5, 0, 0, 5
"f:\研奇\dashboard-view\src\svg\icons\_lock_deft.svg", "XML", 0, 0, 0, 0, 1, 0, 0, 1
"f:\研奇\dashboard-view\src\svg\icons\_originLogo.svg", "XML", 0, 0, 0, 0, 31, 0, 1, 32
"f:\研奇\dashboard-view\src\svg\icons\_originSingle.svg", "XML", 0, 0, 0, 0, 1, 0, 0, 1
"f:\研奇\dashboard-view\src\svg\icons\_originsysText.svg", "XML", 0, 0, 0, 0, 1, 0, 0, 1
"f:\研奇\dashboard-view\src\svg\icons\_red_alarm.svg", "XML", 0, 0, 0, 0, 22, 0, 1, 23
"f:\研奇\dashboard-view\src\svg\icons\_removeBackground_deft.svg", "XML", 0, 0, 0, 0, 1, 0, 0, 1
"f:\研奇\dashboard-view\src\svg\icons\_save_deft.svg", "XML", 0, 0, 0, 0, 1, 0, 0, 1
"f:\研奇\dashboard-view\src\svg\icons\_shutdown_TL.svg", "XML", 0, 0, 0, 0, 5, 0, 0, 5
"f:\研奇\dashboard-view\src\svg\icons\_snow_TF.svg", "XML", 0, 0, 0, 0, 4, 0, 0, 4
"f:\研奇\dashboard-view\src\svg\icons\_snow_TL.svg", "XML", 0, 0, 0, 0, 5, 0, 0, 5
"f:\研奇\dashboard-view\src\svg\icons\_sun_TF.svg", "XML", 0, 0, 0, 0, 16, 0, 0, 16
"f:\研奇\dashboard-view\src\svg\icons\_sun_TL.svg", "XML", 0, 0, 0, 0, 42, 0, 0, 42
"f:\研奇\dashboard-view\src\svg\icons\_terminusENCNBlack.svg", "XML", 0, 0, 0, 0, 1, 0, 0, 1
"f:\研奇\dashboard-view\src\svg\icons\_user_deft.svg", "XML", 0, 0, 0, 0, 1, 0, 0, 1
"f:\研奇\dashboard-view\src\svg\icons\_yellow_alarm.svg", "XML", 0, 0, 0, 0, 22, 0, 1, 23
"f:\研奇\dashboard-view\src\svg\icons\add.svg", "XML", 0, 0, 0, 0, 6, 0, 1, 7
"f:\研奇\dashboard-view\src\svg\icons\delete.svg", "XML", 0, 0, 0, 0, 4, 0, 1, 5
"f:\研奇\dashboard-view\src\svg\icons\delete_one.svg", "XML", 0, 0, 0, 0, 4, 0, 1, 5
"f:\研奇\dashboard-view\src\svg\icons\delete_red.svg", "XML", 0, 0, 0, 0, 4, 0, 1, 5
"f:\研奇\dashboard-view\src\svg\icons\deviceA.svg", "XML", 0, 0, 0, 0, 4, 0, 1, 5
"f:\研奇\dashboard-view\src\svg\icons\deviceB.svg", "XML", 0, 0, 0, 0, 4, 0, 1, 5
"f:\研奇\dashboard-view\src\svg\icons\deviceC.svg", "XML", 0, 0, 0, 0, 4, 0, 1, 5
"f:\研奇\dashboard-view\src\svg\icons\dismiss.svg", "XML", 0, 0, 0, 0, 4, 0, 1, 5
"f:\研奇\dashboard-view\src\svg\icons\edit.svg", "XML", 0, 0, 0, 0, 4, 0, 1, 5
"f:\研奇\dashboard-view\src\svg\icons\error_page.svg", "XML", 0, 0, 0, 0, 521, 1, 41, 563
"f:\研奇\dashboard-view\src\svg\icons\expand.svg", "XML", 0, 0, 0, 0, 4, 0, 1, 5
"f:\研奇\dashboard-view\src\svg\icons\export.svg", "XML", 0, 0, 0, 0, 4, 0, 1, 5
"f:\研奇\dashboard-view\src\svg\icons\file.svg", "XML", 0, 0, 0, 0, 4, 0, 1, 5
"f:\研奇\dashboard-view\src\svg\icons\graphic_deft.svg", "XML", 0, 0, 0, 0, 1, 0, 0, 1
"f:\研奇\dashboard-view\src\svg\icons\humanSensorOff.svg", "XML", 0, 0, 0, 0, 11, 0, 0, 11
"f:\研奇\dashboard-view\src\svg\icons\humanSensorOn.svg", "XML", 0, 0, 0, 0, 25, 0, 0, 25
"f:\研奇\dashboard-view\src\svg\icons\import.svg", "XML", 0, 0, 0, 0, 4, 0, 1, 5
"f:\研奇\dashboard-view\src\svg\icons\lightOff.svg", "XML", 0, 0, 0, 0, 10, 0, 0, 10
"f:\研奇\dashboard-view\src\svg\icons\lightOn.svg", "XML", 0, 0, 0, 0, 22, 0, 0, 22
"f:\研奇\dashboard-view\src\svg\icons\list.svg", "XML", 0, 0, 0, 0, 4, 0, 1, 5
"f:\研奇\dashboard-view\src\svg\icons\loading.svg", "XML", 0, 0, 0, 0, 63, 0, 2, 65
"f:\研奇\dashboard-view\src\svg\icons\logo.svg", "XML", 0, 0, 0, 0, 22, 0, 0, 22
"f:\研奇\dashboard-view\src\svg\icons\lubanx_dark.svg", "XML", 0, 0, 0, 0, 14, 0, 0, 14
"f:\研奇\dashboard-view\src\svg\icons\modbus-sp.svg", "XML", 0, 0, 0, 0, 36, 0, 1, 37
"f:\研奇\dashboard-view\src\svg\icons\modbus-tf.svg", "XML", 0, 0, 0, 0, 11, 0, 1, 12
"f:\研奇\dashboard-view\src\svg\icons\motorOff.svg", "XML", 0, 0, 0, 0, 20, 0, 0, 20
"f:\研奇\dashboard-view\src\svg\icons\motorOn.svg", "XML", 0, 0, 0, 0, 22, 0, 0, 22
"f:\研奇\dashboard-view\src\svg\icons\picture.svg", "XML", 0, 0, 0, 0, 9, 0, 1, 10
"f:\研奇\dashboard-view\src\svg\icons\restart.svg", "XML", 0, 0, 0, 0, 4, 0, 1, 5
"f:\研奇\dashboard-view\src\svg\icons\separator.svg", "XML", 0, 0, 0, 0, 3, 0, 1, 4
"f:\研奇\dashboard-view\src\svg\icons\template.svg", "XML", 0, 0, 0, 0, 4, 0, 1, 5
"f:\研奇\dashboard-view\src\svg\icons\waterLeakSensorOff.svg", "XML", 0, 0, 0, 0, 26, 0, 0, 26
"f:\研奇\dashboard-view\src\svg\icons\waterLeakSensorOn.svg", "XML", 0, 0, 0, 0, 28, 0, 0, 28
"f:\研奇\dashboard-view\src\utils\components.ts", "TypeScript", 0, 19, 0, 0, 0, 8, 4, 31
"f:\研奇\dashboard-view\src\utils\crypto.ts", "TypeScript", 0, 19, 0, 0, 0, 12, 4, 35
"f:\研奇\dashboard-view\src\utils\file.ts", "TypeScript", 0, 32, 0, 0, 0, 20, 3, 55
"f:\研奇\dashboard-view\src\utils\index.ts", "TypeScript", 0, 9, 0, 0, 0, 0, 1, 10
"f:\研奇\dashboard-view\src\utils\plugin.ts", "TypeScript", 0, 96, 0, 0, 0, 27, 7, 130
"f:\研奇\dashboard-view\src\utils\router.ts", "TypeScript", 0, 114, 0, 0, 0, 63, 16, 193
"f:\研奇\dashboard-view\src\utils\storage.ts", "TypeScript", 0, 37, 0, 0, 0, 29, 7, 73
"f:\研奇\dashboard-view\src\utils\style.ts", "TypeScript", 0, 97, 0, 0, 0, 51, 16, 164
"f:\研奇\dashboard-view\src\utils\type.ts", "TypeScript", 0, 25, 0, 0, 0, 0, 8, 33
"f:\研奇\dashboard-view\src\utils\utils.ts", "TypeScript", 0, 317, 0, 0, 0, 122, 41, 480
"f:\研奇\dashboard-view\src\views\chart\ContentBox\index.ts", "TypeScript", 0, 2, 0, 0, 0, 0, 2, 4
"f:\研奇\dashboard-view\src\views\chart\ContentBox\index.vue", "Vue", 158, 0, 0, 0, 0, 1, 26, 185
"f:\研奇\dashboard-view\src\views\chart\ContentCharts\components\ChartsItemBox\index.ts", "TypeScript", 0, 2, 0, 0, 0, 0, 2, 4
"f:\研奇\dashboard-view\src\views\chart\ContentCharts\components\ChartsItemBox\index.vue", "Vue", 294, 0, 0, 0, 0, 3, 17, 314
"f:\研奇\dashboard-view\src\views\chart\ContentCharts\components\ChartsOptionContent\index.ts", "TypeScript", 0, 2, 0, 0, 0, 0, 2, 4
"f:\研奇\dashboard-view\src\views\chart\ContentCharts\components\ChartsOptionContent\index.vue", "Vue", 148, 0, 0, 0, 0, 1, 14, 163
"f:\研奇\dashboard-view\src\views\chart\ContentCharts\components\ChartsSearch\index.ts", "TypeScript", 0, 2, 0, 0, 0, 0, 2, 4
"f:\研奇\dashboard-view\src\views\chart\ContentCharts\components\ChartsSearch\index.vue", "Vue", 277, 0, 0, 0, 0, 0, 19, 296
"f:\研奇\dashboard-view\src\views\chart\ContentCharts\hooks\useAside.hook.ts", "TypeScript", 0, 77, 0, 0, 0, 10, 9, 96
"f:\研奇\dashboard-view\src\views\chart\ContentCharts\hooks\useLayout.hook.ts", "TypeScript", 0, 12, 0, 0, 0, 4, 4, 20
"f:\研奇\dashboard-view\src\views\chart\ContentCharts\index.ts", "TypeScript", 0, 2, 0, 0, 0, 0, 2, 4
"f:\研奇\dashboard-view\src\views\chart\ContentCharts\index.vue", "Vue", 99, 0, 0, 0, 0, 2, 6, 107
"f:\研奇\dashboard-view\src\views\chart\ContentConfigurations\components\CanvasPage\components\ChartThemeColor\index.vue", "Vue", 122, 0, 0, 0, 0, 1, 17, 140
"f:\研奇\dashboard-view\src\views\chart\ContentConfigurations\components\CanvasPage\components\CreateColorRenderChart\barOptions.ts", "TypeScript", 0, 43, 0, 0, 0, 0, 5, 48
"f:\研奇\dashboard-view\src\views\chart\ContentConfigurations\components\CanvasPage\components\CreateColorRenderChart\index.ts", "TypeScript", 0, 2, 0, 0, 0, 0, 2, 4
"f:\研奇\dashboard-view\src\views\chart\ContentConfigurations\components\CanvasPage\components\CreateColorRenderChart\index.vue", "Vue", 62, 0, 0, 0, 0, 0, 5, 67
"f:\研奇\dashboard-view\src\views\chart\ContentConfigurations\components\CanvasPage\components\CreateColorRenderChart\lineOptions.ts", "TypeScript", 0, 68, 0, 0, 0, 0, 5, 73
"f:\研奇\dashboard-view\src\views\chart\ContentConfigurations\components\CanvasPage\components\CreateColorRender\index.ts", "TypeScript", 0, 2, 0, 0, 0, 0, 2, 4
"f:\研奇\dashboard-view\src\views\chart\ContentConfigurations\components\CanvasPage\components\CreateColorRender\index.vue", "Vue", 258, 0, 0, 0, 0, 4, 23, 285
"f:\研奇\dashboard-view\src\views\chart\ContentConfigurations\components\CanvasPage\components\CreateColor\index.vue", "Vue", 371, 0, 0, 0, 0, 4, 19, 394
"f:\研奇\dashboard-view\src\views\chart\ContentConfigurations\components\CanvasPage\index.ts", "TypeScript", 0, 2, 0, 0, 0, 0, 2, 4
"f:\研奇\dashboard-view\src\views\chart\ContentConfigurations\components\CanvasPage\index.vue", "Vue", 318, 0, 0, 0, 0, 23, 25, 366
"f:\研奇\dashboard-view\src\views\chart\ContentConfigurations\components\ChartAnimation\index.vue", "Vue", 84, 0, 0, 0, 0, 0, 10, 94
"f:\研奇\dashboard-view\src\views\chart\ContentConfigurations\components\ChartBindData\index.d.ts", "TypeScript", 0, 0, 0, 0, 0, 0, 1, 1
"f:\研奇\dashboard-view\src\views\chart\ContentConfigurations\components\ChartBindData\index.vue", "Vue", 108, 0, 0, 0, 0, 0, 15, 123
"f:\研奇\dashboard-view\src\views\chart\ContentConfigurations\components\ChartData\components\ChartDataAjax\index.ts", "TypeScript", 0, 2, 0, 0, 0, 0, 2, 4
"f:\研奇\dashboard-view\src\views\chart\ContentConfigurations\components\ChartData\components\ChartDataAjax\index.vue", "Vue", 177, 0, 0, 0, 0, 3, 22, 202
"f:\研奇\dashboard-view\src\views\chart\ContentConfigurations\components\ChartData\components\ChartDataMatchingAndShow\index.ts", "TypeScript", 0, 2, 0, 0, 0, 0, 2, 4
"f:\研奇\dashboard-view\src\views\chart\ContentConfigurations\components\ChartData\components\ChartDataMatchingAndShow\index.vue", "Vue", 197, 0, 0, 0, 0, 0, 13, 210
"f:\研奇\dashboard-view\src\views\chart\ContentConfigurations\components\ChartData\components\ChartDataMonacoEditor\index.ts", "TypeScript", 0, 2, 0, 0, 0, 0, 2, 4
"f:\研奇\dashboard-view\src\views\chart\ContentConfigurations\components\ChartData\components\ChartDataMonacoEditor\index.vue", "Vue", 200, 0, 0, 0, 0, 2, 14, 216
"f:\研奇\dashboard-view\src\views\chart\ContentConfigurations\components\ChartData\components\ChartDataPond\components\ChartDataDisplay\displayTable.vue", "Vue", 60, 0, 0, 0, 0, 0, 4, 64
"f:\研奇\dashboard-view\src\views\chart\ContentConfigurations\components\ChartData\components\ChartDataPond\components\ChartDataDisplay\index.ts", "TypeScript", 0, 2, 0, 0, 0, 0, 2, 4
"f:\研奇\dashboard-view\src\views\chart\ContentConfigurations\components\ChartData\components\ChartDataPond\components\ChartDataDisplay\index.vue", "Vue", 170, 0, 0, 0, 0, 7, 15, 192
"f:\研奇\dashboard-view\src\views\chart\ContentConfigurations\components\ChartData\components\ChartDataPond\components\ChartDataPondControl\index.ts", "TypeScript", 0, 2, 0, 0, 0, 0, 2, 4
"f:\研奇\dashboard-view\src\views\chart\ContentConfigurations\components\ChartData\components\ChartDataPond\components\ChartDataPondControl\index.vue", "Vue", 214, 0, 0, 0, 0, 5, 16, 235
"f:\研奇\dashboard-view\src\views\chart\ContentConfigurations\components\ChartData\components\ChartDataPond\components\ChartDataPondList\index.ts", "TypeScript", 0, 2, 0, 0, 0, 0, 2, 4
"f:\研奇\dashboard-view\src\views\chart\ContentConfigurations\components\ChartData\components\ChartDataPond\components\ChartDataPondList\index.vue", "Vue", 185, 0, 0, 0, 0, 1, 15, 201
"f:\研奇\dashboard-view\src\views\chart\ContentConfigurations\components\ChartData\components\ChartDataPond\index.ts", "TypeScript", 0, 2, 0, 0, 0, 0, 2, 4
"f:\研奇\dashboard-view\src\views\chart\ContentConfigurations\components\ChartData\components\ChartDataPond\index.vue", "Vue", 164, 0, 0, 0, 0, 4, 19, 187
"f:\研奇\dashboard-view\src\views\chart\ContentConfigurations\components\ChartData\components\ChartDataRequest\components\RequestGlobalConfig\index.ts", "TypeScript", 0, 2, 0, 0, 0, 0, 2, 4
"f:\研奇\dashboard-view\src\views\chart\ContentConfigurations\components\ChartData\components\ChartDataRequest\components\RequestGlobalConfig\index.vue", "Vue", 98, 0, 0, 0, 0, 5, 6, 109
"f:\研奇\dashboard-view\src\views\chart\ContentConfigurations\components\ChartData\components\ChartDataRequest\components\RequestGlobalHeaderTable\index.ts", "TypeScript", 0, 2, 0, 0, 0, 0, 2, 4
"f:\研奇\dashboard-view\src\views\chart\ContentConfigurations\components\ChartData\components\ChartDataRequest\components\RequestGlobalHeaderTable\index.vue", "Vue", 38, 0, 0, 0, 0, 1, 7, 46
"f:\研奇\dashboard-view\src\views\chart\ContentConfigurations\components\ChartData\components\ChartDataRequest\components\RequestHeaderTable\index.ts", "TypeScript", 0, 2, 0, 0, 0, 0, 2, 4
"f:\研奇\dashboard-view\src\views\chart\ContentConfigurations\components\ChartData\components\ChartDataRequest\components\RequestHeaderTable\index.vue", "Vue", 151, 0, 0, 0, 0, 0, 11, 162
"f:\研奇\dashboard-view\src\views\chart\ContentConfigurations\components\ChartData\components\ChartDataRequest\components\RequestHeader\index.ts", "TypeScript", 0, 2, 0, 0, 0, 0, 2, 4
"f:\研奇\dashboard-view\src\views\chart\ContentConfigurations\components\ChartData\components\ChartDataRequest\components\RequestHeader\index.vue", "Vue", 119, 0, 0, 0, 0, 6, 14, 139
"f:\研奇\dashboard-view\src\views\chart\ContentConfigurations\components\ChartData\components\ChartDataRequest\components\RequestTargetConfig\index.ts", "TypeScript", 0, 2, 0, 0, 0, 0, 2, 4
"f:\研奇\dashboard-view\src\views\chart\ContentConfigurations\components\ChartData\components\ChartDataRequest\components\RequestTargetConfig\index.vue", "Vue", 159, 0, 0, 0, 0, 3, 6, 168
"f:\研奇\dashboard-view\src\views\chart\ContentConfigurations\components\ChartData\components\ChartDataRequest\index.ts", "TypeScript", 0, 3, 0, 0, 0, 0, 2, 5
"f:\研奇\dashboard-view\src\views\chart\ContentConfigurations\components\ChartData\components\ChartDataRequest\index.vue", "Vue", 85, 0, 0, 0, 0, 1, 8, 94
"f:\研奇\dashboard-view\src\views\chart\ContentConfigurations\components\ChartData\components\ChartDataRequest\pondIndex.vue", "Vue", 99, 0, 0, 0, 0, 1, 9, 109
"f:\研奇\dashboard-view\src\views\chart\ContentConfigurations\components\ChartData\components\ChartDataStatic\index.ts", "TypeScript", 0, 2, 0, 0, 0, 0, 2, 4
"f:\研奇\dashboard-view\src\views\chart\ContentConfigurations\components\ChartData\components\ChartDataStatic\index.vue", "Vue", 14, 0, 0, 0, 0, 0, 3, 17
"f:\研奇\dashboard-view\src\views\chart\ContentConfigurations\components\ChartData\hooks\useFile.hooks.ts", "TypeScript", 0, 42, 0, 0, 0, 3, 5, 50
"f:\研奇\dashboard-view\src\views\chart\ContentConfigurations\components\ChartData\index.d.ts", "TypeScript", 0, 92, 0, 0, 0, 5, 8, 105
"f:\研奇\dashboard-view\src\views\chart\ContentConfigurations\components\ChartData\index.vue", "Vue", 45, 0, 0, 0, 0, 3, 6, 54
"f:\研奇\dashboard-view\src\views\chart\ContentConfigurations\components\ChartEvent\components\ChartEventAdvancedHandle\importTemplate.ts", "TypeScript", 0, 164, 0, 0, 0, 15, 11, 190
"f:\研奇\dashboard-view\src\views\chart\ContentConfigurations\components\ChartEvent\components\ChartEventAdvancedHandle\index.ts", "TypeScript", 0, 2, 0, 0, 0, 0, 2, 4
"f:\研奇\dashboard-view\src\views\chart\ContentConfigurations\components\ChartEvent\components\ChartEventAdvancedHandle\index.vue", "Vue", 226, 0, 0, 0, 0, 8, 18, 252
"f:\研奇\dashboard-view\src\views\chart\ContentConfigurations\components\ChartEvent\components\ChartEventBaseHandle\index.ts", "TypeScript", 0, 2, 0, 0, 0, 0, 2, 4
"f:\研奇\dashboard-view\src\views\chart\ContentConfigurations\components\ChartEvent\components\ChartEventBaseHandle\index.vue", "Vue", 191, 0, 0, 0, 0, 8, 17, 216
"f:\研奇\dashboard-view\src\views\chart\ContentConfigurations\components\ChartEvent\components\ChartEventInteraction\index.ts", "TypeScript", 0, 2, 0, 0, 0, 0, 1, 3
"f:\研奇\dashboard-view\src\views\chart\ContentConfigurations\components\ChartEvent\components\ChartEventInteraction\index.vue", "Vue", 244, 0, 0, 0, 0, 1, 30, 275
"f:\研奇\dashboard-view\src\views\chart\ContentConfigurations\components\ChartEvent\components\index.scss", "SCSS", 0, 0, 0, 47, 0, 2, 3, 52
"f:\研奇\dashboard-view\src\views\chart\ContentConfigurations\components\ChartEvent\index.vue", "Vue", 20, 0, 0, 0, 0, 1, 3, 24
"f:\研奇\dashboard-view\src\views\chart\ContentConfigurations\components\ChartSetting\index.vue", "Vue", 18, 0, 0, 0, 0, 5, 3, 26
"f:\研奇\dashboard-view\src\views\chart\ContentConfigurations\components\hooks\useTargetData.hook.ts", "TypeScript", 0, 12, 0, 0, 0, 1, 2, 15
"f:\研奇\dashboard-view\src\views\chart\ContentConfigurations\index.d.ts", "TypeScript", 0, 7, 0, 0, 0, 0, 1, 8
"f:\研奇\dashboard-view\src\views\chart\ContentConfigurations\index.ts", "TypeScript", 0, 2, 0, 0, 0, 0, 2, 4
"f:\研奇\dashboard-view\src\views\chart\ContentConfigurations\index.vue", "Vue", 163, 0, 0, 0, 0, 3, 16, 182
"f:\研奇\dashboard-view\src\views\chart\ContentEdit\components\EditAlignLine\index.ts", "TypeScript", 0, 2, 0, 0, 0, 0, 2, 4
"f:\研奇\dashboard-view\src\views\chart\ContentEdit\components\EditAlignLine\index.vue", "Vue", 264, 0, 0, 0, 0, 0, 22, 286
"f:\研奇\dashboard-view\src\views\chart\ContentEdit\components\EditBottom\index.ts", "TypeScript", 0, 2, 0, 0, 0, 0, 2, 4
"f:\研奇\dashboard-view\src\views\chart\ContentEdit\components\EditBottom\index.vue", "Vue", 156, 0, 0, 0, 0, 6, 18, 180
"f:\研奇\dashboard-view\src\views\chart\ContentEdit\components\EditGroup\index.ts", "TypeScript", 0, 2, 0, 0, 0, 0, 2, 4
"f:\研奇\dashboard-view\src\views\chart\ContentEdit\components\EditGroup\index.vue", "Vue", 120, 0, 0, 0, 0, 1, 9, 130
"f:\研奇\dashboard-view\src\views\chart\ContentEdit\components\EditHistory\index.ts", "TypeScript", 0, 2, 0, 0, 0, 0, 2, 4
"f:\研奇\dashboard-view\src\views\chart\ContentEdit\components\EditHistory\index.vue", "Vue", 148, 0, 0, 0, 0, 0, 12, 160
"f:\研奇\dashboard-view\src\views\chart\ContentEdit\components\EditRange\index.ts", "TypeScript", 0, 2, 0, 0, 0, 0, 2, 4
"f:\研奇\dashboard-view\src\views\chart\ContentEdit\components\EditRange\index.vue", "Vue", 57, 0, 0, 0, 0, 4, 8, 69
"f:\研奇\dashboard-view\src\views\chart\ContentEdit\components\EditRule\index.ts", "TypeScript", 0, 2, 0, 0, 0, 0, 2, 4
"f:\研奇\dashboard-view\src\views\chart\ContentEdit\components\EditRule\index.vue", "Vue", 319, 0, 0, 0, 0, 2, 48, 369
"f:\研奇\dashboard-view\src\views\chart\ContentEdit\components\EditSelect\index.ts", "TypeScript", 0, 2, 0, 0, 0, 0, 2, 4
"f:\研奇\dashboard-view\src\views\chart\ContentEdit\components\EditSelect\index.vue", "Vue", 103, 0, 0, 0, 0, 0, 11, 114
"f:\研奇\dashboard-view\src\views\chart\ContentEdit\components\EditShapeBox\index.ts", "TypeScript", 0, 2, 0, 0, 0, 0, 2, 4
"f:\研奇\dashboard-view\src\views\chart\ContentEdit\components\EditShapeBox\index.vue", "Vue", 148, 0, 0, 0, 0, 2, 20, 170
"f:\研奇\dashboard-view\src\views\chart\ContentEdit\components\EditShortcutKey\ShortcutKeyModal.vue", "Vue", 132, 0, 0, 0, 0, 6, 10, 148
"f:\研奇\dashboard-view\src\views\chart\ContentEdit\components\EditShortcutKey\index.ts", "TypeScript", 0, 2, 0, 0, 0, 0, 0, 2
"f:\研奇\dashboard-view\src\views\chart\ContentEdit\components\EditShortcutKey\index.vue", "Vue", 38, 0, 0, 0, 0, 0, 4, 42
"f:\研奇\dashboard-view\src\views\chart\ContentEdit\components\EditTools\hooks\useFile.hooks.ts", "TypeScript", 0, 60, 0, 0, 0, 5, 5, 70
"f:\研奇\dashboard-view\src\views\chart\ContentEdit\components\EditTools\hooks\useSyncUpdate.hook.ts", "TypeScript", 0, 58, 0, 0, 0, 17, 15, 90
"f:\研奇\dashboard-view\src\views\chart\ContentEdit\components\EditTools\index.d.ts", "TypeScript", 0, 11, 0, 0, 0, 0, 2, 13
"f:\研奇\dashboard-view\src\views\chart\ContentEdit\components\EditTools\index.ts", "TypeScript", 0, 2, 0, 0, 0, 0, 2, 4
"f:\研奇\dashboard-view\src\views\chart\ContentEdit\components\EditTools\index.vue", "Vue", 362, 0, 0, 0, 0, 4, 19, 385
"f:\研奇\dashboard-view\src\views\chart\ContentEdit\components\EditTools\utils\index.ts", "TypeScript", 0, 7, 0, 0, 0, 25, 6, 38
"f:\研奇\dashboard-view\src\views\chart\ContentEdit\components\EditWatermark\index.ts", "TypeScript", 0, 2, 0, 0, 0, 0, 2, 4
"f:\研奇\dashboard-view\src\views\chart\ContentEdit\components\EditWatermark\index.vue", "Vue", 27, 0, 0, 0, 0, 0, 2, 29
"f:\研奇\dashboard-view\src\views\chart\ContentEdit\hooks\useDrag.hook.ts", "TypeScript", 0, 282, 0, 0, 0, 54, 58, 394
"f:\研奇\dashboard-view\src\views\chart\ContentEdit\hooks\useLayout.hook.ts", "TypeScript", 0, 24, 0, 0, 0, 4, 5, 33
"f:\研奇\dashboard-view\src\views\chart\ContentEdit\hooks\useStyle.hook.ts", "TypeScript", 0, 51, 0, 0, 0, 4, 11, 66
"f:\研奇\dashboard-view\src\views\chart\ContentEdit\index.ts", "TypeScript", 0, 2, 0, 0, 0, 0, 2, 4
"f:\研奇\dashboard-view\src\views\chart\ContentEdit\index.vue", "Vue", 193, 0, 0, 0, 0, 9, 21, 223
"f:\研奇\dashboard-view\src\views\chart\ContentHeader\headerLeftBtn\index.ts", "TypeScript", 0, 2, 0, 0, 0, 0, 2, 4
"f:\研奇\dashboard-view\src\views\chart\ContentHeader\headerLeftBtn\index.vue", "Vue", 141, 0, 0, 0, 0, 2, 18, 161
"f:\研奇\dashboard-view\src\views\chart\ContentHeader\headerRightBtn\index.ts", "TypeScript", 0, 2, 0, 0, 0, 0, 2, 4
"f:\研奇\dashboard-view\src\views\chart\ContentHeader\headerRightBtn\index.vue", "Vue", 184, 0, 0, 0, 0, 0, 19, 203
"f:\研奇\dashboard-view\src\views\chart\ContentHeader\headerTitle\index.ts", "TypeScript", 0, 2, 0, 0, 0, 0, 2, 4
"f:\研奇\dashboard-view\src\views\chart\ContentHeader\headerTitle\index.vue", "Vue", 94, 0, 0, 0, 0, 0, 17, 111
"f:\研奇\dashboard-view\src\views\chart\ContentLayers\components\LayersGroupListItem\index.ts", "TypeScript", 0, 2, 0, 0, 0, 0, 2, 4
"f:\研奇\dashboard-view\src\views\chart\ContentLayers\components\LayersGroupListItem\index.vue", "Vue", 252, 0, 0, 0, 0, 0, 26, 278
"f:\研奇\dashboard-view\src\views\chart\ContentLayers\components\LayersListItem\index.ts", "TypeScript", 0, 2, 0, 0, 0, 0, 2, 4
"f:\研奇\dashboard-view\src\views\chart\ContentLayers\components\LayersListItem\index.vue", "Vue", 145, 0, 0, 0, 0, 0, 19, 164
"f:\研奇\dashboard-view\src\views\chart\ContentLayers\components\LayersStatus\index.ts", "TypeScript", 0, 2, 0, 0, 0, 0, 2, 4
"f:\研奇\dashboard-view\src\views\chart\ContentLayers\components\LayersStatus\index.vue", "Vue", 77, 0, 0, 0, 0, 0, 10, 87
"f:\研奇\dashboard-view\src\views\chart\ContentLayers\enums.ts", "TypeScript", 0, 0, 0, 0, 0, 0, 1, 1
"f:\研奇\dashboard-view\src\views\chart\ContentLayers\index.ts", "TypeScript", 0, 2, 0, 0, 0, 0, 2, 4
"f:\研奇\dashboard-view\src\views\chart\ContentLayers\index.vue", "Vue", 209, 0, 0, 0, 0, 5, 20, 234
"f:\研奇\dashboard-view\src\views\chart\ContentLoad\index.ts", "TypeScript", 0, 2, 0, 0, 0, 0, 2, 4
"f:\研奇\dashboard-view\src\views\chart\ContentLoad\index.vue", "Vue", 37, 0, 0, 0, 0, 0, 4, 41
"f:\研奇\dashboard-view\src\views\chart\hooks\useContextMenu.hook.d.ts", "TypeScript", 0, 10, 0, 0, 0, 0, 1, 11
"f:\研奇\dashboard-view\src\views\chart\hooks\useContextMenu.hook.ts", "TypeScript", 0, 219, 0, 0, 0, 38, 21, 278
"f:\研奇\dashboard-view\src\views\chart\hooks\useKeyboard.hook.ts", "TypeScript", 0, 185, 0, 0, 0, 25, 31, 241
"f:\研奇\dashboard-view\src\views\chart\hooks\useSync.hook.ts", "TypeScript", 0, 176, 0, 0, 0, 44, 16, 236
"f:\研奇\dashboard-view\src\views\chart\index.vue", "Vue", 105, 0, 0, 0, 0, 3, 12, 120
"f:\研奇\dashboard-view\src\views\edit\index.vue", "Vue", 157, 0, 0, 0, 0, 2, 14, 173
"f:\研奇\dashboard-view\src\views\exception\403.vue", "Vue", 41, 0, 0, 0, 0, 0, 4, 45
"f:\研奇\dashboard-view\src\views\exception\404.vue", "Vue", 41, 0, 0, 0, 0, 0, 4, 45
"f:\研奇\dashboard-view\src\views\exception\500.vue", "Vue", 41, 0, 0, 0, 0, 0, 5, 46
"f:\研奇\dashboard-view\src\views\login\index.vue", "Vue", 244, 0, 0, 0, 0, 13, 23, 280
"f:\研奇\dashboard-view\src\views\login\loginbackup.vue", "Vue", 329, 0, 0, 0, 0, 1, 24, 354
"f:\研奇\dashboard-view\src\views\login\modal\ContactModal\index.ts", "TypeScript", 0, 2, 0, 0, 0, 0, 1, 3
"f:\研奇\dashboard-view\src\views\login\modal\ContactModal\index.vue", "Vue", 63, 0, 0, 0, 0, 0, 10, 73
"f:\研奇\dashboard-view\src\views\login\modal\VersionModal\index.ts", "TypeScript", 0, 2, 0, 0, 0, 0, 1, 3
"f:\研奇\dashboard-view\src\views\login\modal\VersionModal\index.vue", "Vue", 123, 0, 0, 0, 0, 0, 16, 139
"f:\研奇\dashboard-view\src\views\preview\components\PreviewLoading\index.ts", "TypeScript", 0, 2, 0, 0, 0, 0, 1, 3
"f:\研奇\dashboard-view\src\views\preview\components\PreviewLoading\index.vue", "Vue", 23, 0, 0, 0, 0, 0, 4, 27
"f:\研奇\dashboard-view\src\views\preview\components\PreviewRenderGroup\index.ts", "TypeScript", 0, 2, 0, 0, 0, 0, 2, 4
"f:\研奇\dashboard-view\src\views\preview\components\PreviewRenderGroup\index.vue", "Vue", 66, 0, 0, 0, 0, 0, 4, 70
"f:\研奇\dashboard-view\src\views\preview\components\PreviewRenderList\index.ts", "TypeScript", 0, 2, 0, 0, 0, 0, 2, 4
"f:\研奇\dashboard-view\src\views\preview\components\PreviewRenderList\index.vue", "Vue", 79, 0, 0, 0, 0, 2, 9, 90
"f:\研奇\dashboard-view\src\views\preview\hooks\useComInstall.hook.ts", "TypeScript", 0, 30, 0, 0, 0, 1, 6, 37
"f:\研奇\dashboard-view\src\views\preview\hooks\useScale.hook.ts", "TypeScript", 0, 131, 0, 0, 0, 4, 11, 146
"f:\研奇\dashboard-view\src\views\preview\hooks\useStore.hook.ts", "TypeScript", 0, 7, 0, 0, 0, 1, 2, 10
"f:\研奇\dashboard-view\src\views\preview\index.d.ts", "TypeScript", 0, 4, 0, 0, 0, 0, 1, 5
"f:\研奇\dashboard-view\src\views\preview\index.vue", "Vue", 8, 0, 0, 0, 0, 0, 2, 10
"f:\研奇\dashboard-view\src\views\preview\suspenseIndex.vue", "Vue", 139, 0, 0, 0, 0, 7, 14, 160
"f:\研奇\dashboard-view\src\views\preview\utils\drag.ts", "TypeScript", 0, 44, 0, 0, 0, 3, 9, 56
"f:\研奇\dashboard-view\src\views\preview\utils\index.ts", "TypeScript", 0, 4, 0, 0, 0, 0, 0, 4
"f:\研奇\dashboard-view\src\views\preview\utils\keyboard.ts", "TypeScript", 0, 42, 0, 0, 0, 2, 6, 50
"f:\研奇\dashboard-view\src\views\preview\utils\storage.ts", "TypeScript", 0, 54, 0, 0, 0, 4, 12, 70
"f:\研奇\dashboard-view\src\views\preview\utils\style.ts", "TypeScript", 0, 46, 0, 0, 0, 6, 7, 59
"f:\研奇\dashboard-view\src\views\preview\wrapper.vue", "Vue", 27, 0, 0, 0, 0, 0, 4, 31
"f:\研奇\dashboard-view\src\views\project\index.vue", "Vue", 49, 0, 0, 0, 0, 3, 6, 58
"f:\研奇\dashboard-view\src\views\project\items\components\ProjectItemsCard\backup.vue", "Vue", 126, 0, 0, 0, 0, 76, 12, 214
"f:\研奇\dashboard-view\src\views\project\items\components\ProjectItemsCard\index.ts", "TypeScript", 0, 2, 0, 0, 0, 0, 2, 4
"f:\研奇\dashboard-view\src\views\project\items\components\ProjectItemsCard\index.vue", "Vue", 134, 0, 0, 0, 0, 0, 21, 155
"f:\研奇\dashboard-view\src\views\project\items\components\ProjectItemsList\hooks\useData.hook.ts", "TypeScript", 0, 48, 0, 0, 0, 4, 6, 58
"f:\研奇\dashboard-view\src\views\project\items\components\ProjectItemsList\hooks\useModal.hook.ts", "TypeScript", 0, 74, 0, 0, 0, 5, 12, 91
"f:\研奇\dashboard-view\src\views\project\items\components\ProjectItemsList\index.ts", "TypeScript", 0, 2, 0, 0, 0, 0, 2, 4
"f:\研奇\dashboard-view\src\views\project\items\components\ProjectItemsList\index.vue", "Vue", 91, 0, 0, 0, 0, 0, 11, 102
"f:\研奇\dashboard-view\src\views\project\items\components\ProjectItemsModalCard\index.ts", "TypeScript", 0, 2, 0, 0, 0, 0, 2, 4
"f:\研奇\dashboard-view\src\views\project\items\components\ProjectItemsModalCard\index.vue", "Vue", 143, 0, 0, 0, 0, 12, 13, 168
"f:\研奇\dashboard-view\src\views\project\items\index.d.ts", "TypeScript", 0, 9, 0, 0, 0, 0, 1, 10
"f:\研奇\dashboard-view\src\views\project\items\index.vue", "Vue", 13, 0, 0, 0, 0, 0, 3, 16
"f:\研奇\dashboard-view\src\views\project\layout\components\ProjectLayoutAsideFooter\index.ts", "TypeScript", 0, 2, 0, 0, 0, 0, 2, 4
"f:\研奇\dashboard-view\src\views\project\layout\components\ProjectLayoutAsideFooter\index.vue", "Vue", 70, 0, 0, 0, 0, 0, 8, 78
"f:\研奇\dashboard-view\src\views\project\layout\components\ProjectLayoutCreate\components\CreateModal\index.ts", "TypeScript", 0, 2, 0, 0, 0, 0, 2, 4
"f:\研奇\dashboard-view\src\views\project\layout\components\ProjectLayoutCreate\components\CreateModal\index.vue", "Vue", 129, 0, 0, 0, 0, 2, 19, 150
"f:\研奇\dashboard-view\src\views\project\layout\components\ProjectLayoutCreate\index.ts", "TypeScript", 0, 2, 0, 0, 0, 0, 2, 4
"f:\研奇\dashboard-view\src\views\project\layout\components\ProjectLayoutCreate\index.vue", "Vue", 33, 0, 0, 0, 0, 1, 6, 40
"f:\研奇\dashboard-view\src\views\project\layout\components\ProjectLayoutSider\index.ts", "TypeScript", 0, 2, 0, 0, 0, 0, 2, 4
"f:\研奇\dashboard-view\src\views\project\layout\components\ProjectLayoutSider\index.vue", "Vue", 136, 0, 0, 0, 0, 2, 19, 157
"f:\研奇\dashboard-view\src\views\project\layout\components\ProjectLayoutSider\menu.ts", "TypeScript", 0, 47, 0, 0, 0, 14, 5, 66
"f:\研奇\dashboard-view\src\views\project\mtTemplate\index.vue", "Vue", 22, 0, 0, 0, 0, 0, 3, 25
"f:\研奇\dashboard-view\src\views\project\templateMarket\index.vue", "Vue", 17, 0, 0, 0, 0, 0, 3, 20
"f:\研奇\dashboard-view\src\views\redirect\index.vue", "Vue", 16, 0, 0, 0, 0, 0, 1, 17
"Total", "-", 20260, 10466, 6466, 526, 1548, 2088, 3683, 45037